Manzara sahane evet ama servis rezalet.	SERVICE#GENERAL AMBIENCE#GENERAL
Soguk su isteyince, soguk yok, butun sulari disari cikardik diyen garson, siparisten tam 2 saat sonra gelen yemekler, yemegin yaninda soylenen roka ve pureden eser olmamasi, istedigimiz 2 mezenin de kalmamis olmasi.	FOOD#STYLE_OPTIONS SERVICE#GENERAL
Yemekler iyi hos, lezzetler iyi ama heyecan verici bi taraflari yok, iyi bir baligi iyi bir sekilde izgara yapmak artik atla deve bi olay degil.	FOOD#QUALITY FOOD#QUALITY FOOD#QUALITY
bu servise bu fiyatlar ise cok faZla.	RESTAURANT#PRICES
Lacivert beni kalitesinin dusukluguyle cok sasirtti	RESTAURANT#GENERAL
Nerden baslasam bilemedim.	
Buraya bu kadar iyi yorum yapanlar her halde daha Ã¶nce hiÃ§ balik yemediler.	FOOD#QUALITY
Kalamardan ve koladan Ã¶nce balik geldi ve apar topar Ã¶nÃ¼mÃ¼ze atildi.	SERVICE#GENERAL
ayrica gelen kalamar soguk ve sÃ¼nger gibiydi.	FOOD#QUALITY
uzun lafin kisasi kesinlikle ve asla bir daha gitmem ve tavsiyede etmem.	RESTAURANT#GENERAL
Daha Ã¶nce de sÃ¶yledigim gibi bÃ¼yÃ¼dÃ¼kÃ§e kalitesi dÃ¼sen yerlerden	RESTAURANT#GENERAL
Kesinlikle ev yemegi degil - Bu kadar basarisiz ev yemekleri olmasina ragmen Ã¶gle saatlerinde ki yogunlugu Ã§Ã¶zebilmis degilim.	FOOD#QUALITY
Ya insanlar gerÃ§ekten ev yemeginin nasil oldugunu bilmiyorlar.	FOOD#QUALITY
Ya da herkes benim gibi 1 kere deniyor ve bir daha gitmiyor.	RESTAURANT#GENERAL
1 kere denedigim fiyatlarinin yÃ¼ksek yemeklerinin lezzetsiz oldugu bir mekan Ã¶nermiyorum.	RESTAURANT#PRICES FOOD#QUALITY
mekanÄ±n giriÅŸinde kasap reyonu Ä±ÅŸÄ±ltÄ±lÄ±,sÄ±cak bir ortam yaratÄ±lmaya Ã§alÄ±ÅŸÄ±lmÄ±ÅŸ manzara olmadÄ±ÄŸÄ± iÃ§in bulunduÄŸu konumda pek samimi bulmadÄ±m.	AMBIENCE#GENERAL
garsonumuz ilgisizdi biz sÃ¶yledikce yaptÄ± buda benim restauranttan beklentimi zayÄ±flatÄ±yor.	SERVICE#GENERAL
lokumun daha iyisini yedim kÃ¼ÅŸleme gÃ¼zeldi.	FOOD#QUALITY FOOD#QUALITY
ÅŸazeli salata yani...	
bilemedim mekana daha sonra belki bir ÅŸans daha verebilirim.	RESTAURANT#GENERAL
2 sene Ã¶nce hÄ±zlÄ± bir kahvaltÄ± yapmak iÃ§in geldiÄŸimiz mekana dair hatÄ±rÄ±mda kalan 6 tl lik Ã§ayÄ± oldu:	DRINKS#PRICES
) menÃ¼de dikkat etmemiÅŸtik ama hesap gelince ufak bir ÅŸok yaÅŸamÄ±ÅŸtÄ±kğŸ˜© gÃ¼zel olabilir ama kahvaltÄ±dan fazla Ã¶dediÄŸimiz Ã§ay yÃ¼zÃ¼nden bir daha uÄŸramadÄ±k.	DRINKS#PRICES RESTAURANT#GENERAL
ÅatobiryanÄ± Ã¶neririm.	FOOD#QUALITY
Sosu tereyagli ve yumusak .	FOOD#QUALITY
Sert et sevmeyenler icin cok lezzetliydi.	FOOD#QUALITY
Guvecte yogurt ve salatayla iyi bir uclu oldu.	FOOD#QUALITY
Servisi hizli valesi var.	SERVICE#GENERAL
Acik mekanda ise gardenya bolumu guzel.	AMBIENCE#GENERAL
Kalabalik icin ideal.	RESTAURANT#GENERAL
Yaninda cafe ve nargile bolumu var.	
Cok fazla cesit var,insanin kafasi karÄ±ÅŸÄ±yor dogrusu.	
Bugun Ã§alÄ±ÅŸan arkadasin yonlendirmesiyle siyah caylardan bourbon vanilla ictik.	FOOD#QUALITY
Vanilya tadi gerÃ§ekten baya hissediliyodu ama ben beyaz caylarini daha cok begenmistim.	DRINKS#QUALITY
Ortam gÃ¼zel,Ã¶zellikle rahat oturma kÃ¶ÅŸeleriğŸ‘Œ Esas kahve sever biri oldugum icin cok tercih ettigim mekan deÄŸil ama yine de arada degisiklik icin guzel olabilir.	AMBIENCE#GENERAL AMBIENCE#GENERAL
YoÄŸun olduÄŸu gÃ¼nlerde(cumartes-pazar) gitmenizi tavsiye etmem.	RESTAURANT#GENERAL
Lezzet deÄŸiÅŸiyor...	
Åubelerden en iyisi Pendik merkez ana ÅŸubesi iyidir.	RESTAURANT#GENERAL
BugÃ¼ne kadar dÄ±ÅŸarÄ±da yediÄŸim en lezzetli kurufasÃ¼lyeci.	FOOD#QUALITY
Bir arkadaÅŸÄ±mÄ±n tavsiyesi ile OrtakÃ¶y ÅŸubesine gittim.	
Fasulyesi aÄŸÄ±zda daÄŸÄ±lÄ±yor adeta, lokum gibi.	FOOD#QUALITY
DuyduÄŸum kadarÄ±yla suda deÄŸil sÃ¼tte bekletiyorlarmÄ±ÅŸ.	FOOD#STYLE_OPTIONS
YanÄ±nda turÅŸu, cacÄ±k veya yoÄŸurtla harika oluyor.	FOOD#STYLE_OPTIONS
PilavÄ± da Ã§ok lezzetli, mis gibi tereyaÄŸ kokuyor.	FOOD#QUALITY FOOD#QUALITY
Finali sÃ¼tlaÃ§la yapmanÄ±zÄ± tavsiye ediyorum.	FOOD#QUALITY
SÃ¼tlacÄ± da enfes.	FOOD#QUALITY
Hard Rock Cafe'de hiÃ§ sÄ±ra beklemeden oturmaya alÄ±ÅŸÄ±k deÄŸiliz ki biz, Avrupa veya Amerika'dakilerle aynÄ± duyguyu vermiyor bu sebeple ama lezzet tabii yine aynÄ±.	FOOD#QUALITY SERVICE#GENERAL
AtÄ±ÅŸtÄ±rmalÄ±k Jumbo Combo pek yummy!	FOOD#QUALITY
Deniz Ã¼rÃ¼nleri Ã§ok baÅŸarÄ±lÄ±.	FOOD#QUALITY
ManzarasÄ± zaten mÃ¼kemmel.	AMBIENCE#GENERAL
BÃ¼tÃ¼n istanbul'un gÃ¼zelliÄŸini, yoÄŸunluÄŸunu hissediyorsun.	AMBIENCE#GENERAL
Onun dÄ±ÅŸÄ±nda pek Ã¶ÄŸrenci mekanÄ± deÄŸil.	AMBIENCE#GENERAL
Ã–zel gÃ¼nlerde gidilecek, kÃ¼Ã§Ã¼k kutlamalar yapÄ±lacak bir yer	AMBIENCE#GENERAL
RahatÃ§a sohbet edebilmek istiyorsanÄ±z, orta mÃ¼kemmel.	AMBIENCE#GENERAL
Ã‡alan mÃ¼zik tam kÄ±vamÄ±nda, rahatsÄ±z etmiyor.	AMBIENCE#GENERAL
Yemekleri Ã§ok lezzetli, manzara mÃ¼kemmel.	AMBIENCE#GENERAL FOOD#QUALITY
ancak hesap biraz abartÄ±lÄ± geliyor, balÄ±k yemeden kiÅŸi baÅŸÄ± 100 liradan fazla Ã¶dedik, itiraz etmek gerekir.	FOOD#PRICES
Kalabalik zamanlarda servis fazlasiyla aksiyor.	SERVICE#GENERAL
Bosken soylemis oldugum makarna ne kadar hizli geldiyse, mekanin dolmasiyla arkadasimin soylemis oldugu siparis unutuldu, defalarca hatirlatma yapmamiz gerekti.	SERVICE#GENERAL
Ayrica masalarin fazla ic ice olmasi zaman zaman rahatsiz olmaniza neden olabiliyor	AMBIENCE#GENERAL
KÄ±ÅŸ aylarÄ±nda iÃ§erideki sÄ±cak ve loÅŸ Ä±ÅŸÄ±klÄ± ortamÄ±nda gÃ¼zel yemekler yiyebilir, yazÄ±n da dÄ±ÅŸarÄ±da o harika Ã§ilekli magnoliasÄ±ndan tadabilirsiniz.	AMBIENCE#GENERAL FOOD#QUALITY FOOD#QUALITY
Ä°Ã§inizi serinletecek enfes bir tat.	FOOD#QUALITY
Garsonlar suratsiz.	SERVICE#GENERAL
Bu kadar methedilmeyi hakketmiyor.	RESTAURANT#GENERAL
Kasarli kÃ¶ftenin iÃ§inde kasar olmayan ve kÃ¶fte ustasi geÃ§inen bir yer!	FOOD#STYLE_OPTIONS RESTAURANT#GENERAL
AÃ§iklama:	
kasarla kÃ¶fte yoguruluyormus.	
Isletme sahibi kaba.	SERVICE#GENERAL
Bizim kasarli kÃ¶fte tanimimiz bÃ¶yle diyor sadece!	FOOD#STYLE_OPTIONS
MÃ¼steri memnuniyeti sifir!	RESTAURANT#GENERAL
YÄ±llarÄ±n Sampi'si, canÄ±m pide istediÄŸimde eve sipariÅŸ iÃ§in tercih ettiÄŸim yerlerdendir.	FOOD#QUALITY
O zaman keÅŸke baÅŸlangÄ±Ã§larda menÃ¼de yer almasa!	FOOD#STYLE_OPTIONS
BeÅŸiktaÅŸ'ta tam otobÃ¼s duraklarÄ±nÄ±n arkasÄ±nda olmasÄ±ndan dolayÄ± ulaÅŸÄ±mÄ± Ã§ok kolay ve fiyatlarÄ± elbette Ã§ok makul.	RESTAURANT#GENERAL LOCATION#GENERAL
Ä°lk defa bir ÅŸubesine gidip oturup yemek yedim.	
Ben Ã§Ä±tÄ±r pide sevenlerdenim, dolayÄ±sÄ±yla sipariÅŸi verirken Ã¶zellikle rica ettim ve gerÃ§ekten de Ã§itir Ã§itir pide geldi.	FOOD#STYLE_OPTIONS
Ancak maalesef birlikte gittiÄŸim arkadaÅŸlarÄ±m hiÃ§ sevmezmiÅŸ Ã§Ä±tÄ±r pideyi ve tabii ki onlarÄ±n ki de Ã§Ä±tÄ±r geldi.	FOOD#STYLE_OPTIONS
Evet suÃ§luyum!	
Tek ayak Ã¼stÃ¼nde kÃ¶ÅŸeme Ã§ekiliyorum!	
Neyse tadÄ± paket servisten elbette Ã§ok daha iyidi neticede beklemeden yeme imkanÄ±nÄ±z var.	FOOD#QUALITY
Malzemesi bol, porsiyonu tam kÄ±vamÄ±ndaydÄ±.	FOOD#STYLE_OPTIONS FOOD#STYLE_OPTIONS
BaÅŸlangÄ±Ã§ olarak Lahmacun sipariÅŸ etmek istemiÅŸtik, ancak garson Lahmacunun Pide'den daha uzun sÃ¼rdÃ¼ÄŸÃ¼nÃ¼ belirtti, Ã§Ã¼nkÃ¼ hamuru taze aÃ§Ä±lÄ±yormuÅŸ.	
BeÅŸiktaÅŸ'Ä±n gÃ¶beÄŸinde.	LOCATION#GENERAL
Ã‡ok da pide delisi olmayan, baÅŸka bir ÅŸubesine bugÃ¼ne kadar da hiÃ§ gitmemiÅŸ biri.	
Ve deneyim maalesef Ã§ok da olumlu olmadÄ±.	RESTAURANT#GENERAL
Pide lezzeti lafÄ±m yok, ama sipariÅŸ verirken bir arkadaÅŸÄ±mÄ±zÄ±n kenarlarÄ±nÄ± Ã§Ä±tÄ±r Ã§Ä±tÄ±r istemesini yanlÄ±ÅŸ anlamÄ±ÅŸ olacak ki, tÃ¼m sipariÅŸleri Ã§Ä±tÄ±r Ã§Ä±tÄ±r getirdi.	FOOD#QUALITY SERVICE#GENERAL
SevmediÄŸimden yiyemedim kenarlarÄ±nÄ±, ama ortasÄ± pek lezizdi.	FOOD#QUALITY FOOD#STYLE_OPTIONS
BaÅŸlangÄ±Ã§ iÃ§in menÃ¼de baÅŸlangÄ±Ã§larda yer alan lahmacunun, ana yiyecek pideden daha geÃ§ gelecek olmasÄ± ise ayrÄ± bi durumdu tabii.	SERVICE#GENERAL
Yemek yemek iÃ§in Ã§ok fazla vaktiniz yoksa, bÃ¼tÃ§eyi Ã§ok sarsmayalÄ±m, Ã§ok keyifli yemek yemesek de olur yeter ki karnÄ±mÄ±z doysun diye dÃ¼ÅŸÃ¼nenler iÃ§in Ã‡arÅŸÄ±'nÄ±n gÃ¶beÄŸinde Sampi gayet ideal.	FOOD#QUALITY RESTAURANT#PRICES
Servis:	
4 Fiyat:	
5 Mekan:	
8 Lezzet:	
4 sicak iceceklerde servis agir, kahvalti icin tercih edilwbilir olsa da lezzete gore fiyat yuksek kaliyor.	FOOD#QUALITY FOOD#PRICES SERVICE#GENERAL
Mutlaka bir hafta Ã¶nceden rezarvasyon yaptÄ±rÄ±n iyi bir rum meyhanesi yemekleri baÅŸarÄ±lÄ± olduÄŸu gibi ÅŸahane bir manzarasÄ± var bu mekanÄ±n en bÃ¼yÃ¼k olayÄ± sÃ¼rekli ikram yapmalarÄ±dÄ±r pahalÄ± olmasÄ±na raÄŸmen hak ediyor.	FOOD#QUALITY FOOD#STYLE_OPTIONS AMBIENCE#GENERAL
Mutlaka Ä±zgara mantar ve istakoz kavurma deneyin gittiÄŸim ve hiÃ§bir zaman piÅŸman olmadÄ±ÄŸÄ±m ender yerlerden biridir	RESTAURANT#GENERAL FOOD#QUALITY FOOD#QUALITY
Baliklarin yanina Rum ve ermeni mutfagindan mezelerde pek bir yakisiyor.	FOOD#QUALITY
kuskonmaz somon sarma,kagitta balik pastirma kesinlikle denenmeli.	FOOD#QUALITY FOOD#QUALITY
Burada caylar harika!	DRINKS#QUALITY
Bourbon Vanilla 34 numarali cay.	
Vanilla ve portakal aromasina doyamayacaginiz harika bir lezzet olmus.	FOOD#QUALITY
Ortam muhabbet edebilmek icin gayet guzel fakat manzara beklentiniz var ise baska yeri tercih etmelisiniz.	AMBIENCE#GENERAL AMBIENCE#GENERAL
Tam tamina 60 farkli cesit cay bulabileceginiz bu mekani ziyaret etmelisiniz!	DRINKS#STYLE_OPTIONS
HoÅŸ bi mekan, severek giderim ve ayrÄ±lÄ±rken de memnuniyetle ayrÄ±lÄ±rÄ±m her zaman.	RESTAURANT#GENERAL
Ã–zellikle akÅŸamlarÄ± gidilmesini tavsiye ederim, kÃ¶prÃ¼nÃ¼n ve hisarÄ±n Ä±ÅŸÄ±klarÄ± yandÄ±ÄŸÄ±nda ayrÄ± bi zevki var.	AMBIENCE#GENERAL
Hemde canlÄ± mÃ¼zikle :	AMBIENCE#GENERAL
Daha iyisi var.	RESTAURANT#GENERAL
Buranin doneri dedikleri kadar efsane degil.	FOOD#QUALITY
Eti yagli , kokuyor, ince dilinmis ve en kotusu aradan 3 saat gecmesine ragmen migdem bulaniyor.	FOOD#QUALITY FOOD#STYLE_OPTIONS
Ortami da begenmedim kalabalik 3. Sinif bir yer.	AMBIENCE#GENERAL
Bir daha gitmem	RESTAURANT#GENERAL
Eti lezzetli, mekan gÃ¶steriÅŸli.	AMBIENCE#GENERAL FOOD#QUALITY
Ama sunum resmen sÄ±fÄ±r.	SERVICE#GENERAL
30 tl aldÄ±ÄŸÄ±nÄ±z hamburger iÃ§in dÃ¼z beyaz tabaÄŸa koymaktan Ã¶teye gidebilirsiniz bence?	FOOD#STYLE_OPTIONS
HavuÃ§ dilimi ise aÅŸÄ±rÄ± yaÄŸlÄ± ve ÅŸerbetli.	FOOD#QUALITY
Pek yaratÄ±cÄ± Ã¶zel bir yanÄ± yok.	RESTAURANT#GENERAL
Pazar gÃ¼nÃ¼ 14.30'a kadar kahvaltÄ± dÄ±ÅŸÄ± servis yapmayan Big Chefs!	SERVICE#GENERAL
KahvaltÄ± sonrasÄ± kahve iÃ§meye gittik, kapÄ±dan dÃ¶ndÃ¼k ve saat 13.30'du, ÅŸaka sandÄ±m bir an...	SERVICE#GENERAL
OlmadÄ± Big Chefs, zincirsin sen...	RESTAURANT#GENERAL
Leventte ki buyuk alisveris merkezlerinden cok sÄ±kÄ±lmÄ±ÅŸ olarak buraya gidelim dedik.	
Ben kofte durum arkadasim tavuk WRAP( menu de meksika mutfagi olarak adlandirilmis bolumde ismi bÃ¶yle geciyordu biz garson beye tavuk durum diyince garson bey buyuk bi titizlikle onun wrap oldugunu soyledi) istedi.	
Menude yazilmis olmasina ragmen tavuk WRAPimiz patates ile gelmedi nedenini sordugumuz da patatesi kaldirdiklarini menulerini henuz degistirmediklerini soylediler.	FOOD#STYLE_OPTIONS
Gelen tavuk Wrapten 5 dakika sonra biz kofte durum istememize ragmen tavuk sis dÃ¼rÃ¼mu geldi durumu soyledik ve degistirdiler.	SERVICE#GENERAL
Tavuklar kupkuruydu, kofte durum ise siradandi.	FOOD#QUALITY FOOD#QUALITY
Ikisininde yanindaki yesillikler sus icin konulmus olup yemeye kalktigimizda aci bi tatla karsilastik.	FOOD#QUALITY
Zeytinyagli tabagi soyledik icinde fasulye, barbunya, biber dolmasi, sarma ve saksuka vardi.	FOOD#STYLE_OPTIONS
Tadlari yerindeydi fakat az koymak icin bayagi bi zorlamislar kendilerini.	FOOD#STYLE_OPTIONS FOOD#QUALITY
Fiyatlar normal, servis cok yavaÅŸ, tuvaletler ise pis.	SERVICE#GENERAL RESTAURANT#PRICES AMBIENCE#GENERAL
gÃ¼zel olan tek sey manzaraydi, evet Ã§ocuk oyun alani var bakimsiz servis elemanlari suratsiz, hele omlet yapan bir bayan var ki benim oturdugum masa dibindeydi gelen herkese bir surat bir tavir ben bÃ¶yle birsey gÃ¶rmedim .	SERVICE#GENERAL SERVICE#GENERAL AMBIENCE#GENERAL
aÃ§ik bÃ¼fe kahvaltisi evet Ã§esit Ã§oktu ancak sunum beni tatmin etmedi, temizlik hijyen hissi uyandirmadi.	FOOD#STYLE_OPTIONS FOOD#STYLE_OPTIONS
Hos mekan - Mekan yaklasik 3-4 aydir var Tuzla'da.	RESTAURANT#GENERAL
Gidilebilecek iyi yerlerden birisi.	RESTAURANT#GENERAL
Ilk aÃ§ildigi ay gittigimizde Ã§ok memnun kalmistik ama daha sonraki gidislerimizde servisin Ã§ok fazla aksadigina ve garsonlarin yogunluk nedeni ile herkes ile ilgilenememesini gÃ¶zlemledik.	SERVICE#GENERAL SERVICE#GENERAL
Ã‡ok az sayida garson Ã§alisiyor ve bazen mekan dolu olunca yetemiyorlar.	SERVICE#GENERAL
Diger Mado subeleri kadar genis bir menÃ¼ seÃ§enekleri yok.	
Klasik dondurma spesiyalleri ve tatlililari var.	FOOD#STYLE_OPTIONS
Internetten arastirip gittigim bir yerdi, ancak maalesef beklentilerimi Ã§ok karsilamadi.	RESTAURANT#GENERAL
Garsonlar istediginiz seyi en az iki kere istemeden maalesef getirmiyorlar.	SERVICE#GENERAL
Internetteki resimlerinden gÃ¶rÃ¼ndÃ¼gÃ¼ kadar gÃ¼zel degildi.	AMBIENCE#GENERAL
Su bÃ¶regi ile kahvalti yaptim bugÃ¼n.	
Su bÃ¶regi oldukÃ§a lezzetli idi.	FOOD#QUALITY
Ã‡ay kÃ¶tÃ¼ mÃ¼ydÃ¼?	DRINKS#QUALITY
Hayir, Ã§ok taze ve lezzetliydi.	FOOD#QUALITY
Beklentimin Ã¼stÃ¼ndeydi.	RESTAURANT#GENERAL
Her yÃ¶nÃ¼yle ideal - Bizim okula Ã§ok yakin oldugu iÃ§in Ã§ok sik gittigimiz bir yerdir ve muhtesemdir zaten manzarasi.	RESTAURANT#GENERAL AMBIENCE#GENERAL
DÃ¼gÃ¼nler falan da yapilir.	
Ama konaklamasi yok diye biliyorum.	
Yazin daha zevkli oluyor manzaraya karsi oturmasi.	AMBIENCE#GENERAL
Marmara Ã¶grencilerine de indirimli fiyat uygulamasi var.	RESTAURANT#PRICES
O yÃ¼zden de bizim iÃ§in avantajli oluyor.	RESTAURANT#PRICES
GÃ¶zleme yapan teyzeler de var bu yil, kumpir servisine de basladilar.	FOOD#STYLE_OPTIONS
KuafÃ¶rÃ¼ de Ã§ok ucuz ve iyi ayrica.	RESTAURANT#MISCELLANEOUS
Daha ne olsun =)	RESTAURANT#GENERAL
GÃ¼zel manzara ancak fiyat performans olarak mutfak yeterli deÄŸil.	AMBIENCE#GENERAL FOOD#QUALITY
Bu kadar Ã¼nlÃ¼ olmasÄ±nÄ± reklama baÄŸlÄ±yorum Ã§Ã¼nkÃ¼ Ã§ok daha iyi deniz Ã¼rÃ¼nlerini daha uygun fiyatlarla yiyebileceÄŸiniz bir sÃ¼rÃ¼ yer var Ä°stanbul'da.	FOOD#PRICES FOOD#QUALITY
ParanÄ±z Ã§oksa deneyin ama ÅŸart da deÄŸil:	RESTAURANT#GENERAL
DÃ¶ner gÃ¼zel ok ama giderek daha kalabalik hale hatta sisen restoranda omuz omuza kolunuzu kipirdatamadan feci bir gÃ¼rÃ¼ltÃ¼ iÃ§inde yemek yemek zorunda kaliyorsunuz.	AMBIENCE#GENERAL FOOD#QUALITY
Sicak bir ortam - Yeri iyi olmasa da, zevkli dÃ¶senmis, yemekleri sunum ve tat aÃ§isindan tatmin edici, renkli bir mekan.	LOCATION#GENERAL FOOD#STYLE_OPTIONS FOOD#QUALITY AMBIENCE#GENERAL AMBIENCE#GENERAL
Sira bekleme olayi ise Ã§ok kÃ¶tÃ¼...	SERVICE#GENERAL
Aci sevmeyenlere uygun bir mekan degil.	RESTAURANT#GENERAL
Manzara muhtesem,ortam gÃ¼zel ama bir karisik kÃ¶fte tabagi acili kÃ¶fteyle geliyorsa,fajita da aciysa bana uygun degil.	AMBIENCE#GENERAL FOOD#QUALITY FOOD#QUALITY AMBIENCE#GENERAL
Sadece meze yiyin.	FOOD#QUALITY FOOD#QUALITY
Her hafta gelmeye Ã§alÄ±ÅŸÄ±yoruz.	RESTAURANT#GENERAL
BÃ¼tÃ¼n balÄ±klarÄ± deÄŸiÅŸik soslarla piÅŸirip getiriyorlar, siz dur diyene kadar da mezeler gelmeye devam ediyor.	FOOD#STYLE_OPTIONS
Rekorum 9 meze!	
BalÄ±ÄŸÄ±n fast food gibi yenildiÄŸi yer.	FOOD#STYLE_OPTIONS
YavaÅŸ yavaÅŸ balÄ±k keyfi yapmak isterseniz Ã¶nermem.	FOOD#STYLE_OPTIONS
Servisi Ã§ok hÄ±zlÄ±.	SERVICE#GENERAL
MÄ±sÄ±r ekmeÄŸi de sÄ±cacÄ±k bayÄ±lÄ±yorum.	FOOD#QUALITY
60 Ã§eÅŸit Ã§ay, ruh dinlendirici mÃ¼zikler, keyifli ortam, hayal kÄ±rÄ±klÄ±ÄŸÄ± yaratan Mizuno Pudding ve farklÄ± da olsa alt tarafÄ± Ã§ay iÃ§miÅŸtim, bu hesap da ne ÅŸimdi dedirten bir hesap :	AMBIENCE#GENERAL AMBIENCE#GENERAL FOOD#QUALITY DRINKS#STYLE_OPTIONS DRINKS#PRICES
) Evet aynen bÃ¶yle olmuÅŸtu Dem'de...	
Hem Ã§ok keyif almÄ±ÅŸtÄ±m, hem de yok yok bir Ã§ay iÃ§in bu kadar paraya deÄŸmez demiÅŸtim ve Ã¶ve Ã¶ve bitirilmeyen Mizuno Pudding'i beÄŸenmemiÅŸtim.	RESTAURANT#GENERAL DRINKS#PRICES FOOD#QUALITY
PizzalarÄ±nÄ±n methini Ã§ok duyup bir tÃ¼rlÃ¼ gidemediÄŸimiz yerlerden biriydi burasÄ±...	
Neden ÅŸimdiye kadar gelmemiÅŸim dedim.	RESTAURANT#GENERAL
Servisten de oldukÃ§a memnun kaldÄ±k.	SERVICE#GENERAL
Biz erken saatte gittik ama akÅŸamlarÄ± romantik bir yemek iÃ§in oldukÃ§a ideal bir mekan...	AMBIENCE#GENERAL
Hangi gÃ¼n hangi saat gidilse kalabalÄ±ktan kurtulmak mÃ¼mkÃ¼n deÄŸil.	AMBIENCE#GENERAL
Ã‡oluÄŸu Ã§ocuÄŸu toplayan ev hanÄ±mlarÄ± gruplarÄ± mekana olan ilgiyi azaltÄ±yor.	AMBIENCE#GENERAL
Garsonlar iyi.	SERVICE#GENERAL
ÃœrÃ¼nlerin lezzeti diÄŸer SÃ¼tiÅŸ'lerle aynÄ±.	
Ansiklopedi kalinliginda menuyu getirip siparisinizi vermek istediginizde o yok, bu uok,su kalmadi seklinde ifadelerle birturlu istediginiz tatliyi yiyemediginiz mekan isletmecisine konuyu ilettiginizde yapacak birseyleri olmadigini buyuk rahatlikla dile getiren , garsonlarinin sattiklari urunden haberdar olmayip isteklerinizi yerine gec veya yanlis getirmeleride cabasi.	SERVICE#GENERAL SERVICE#GENERAL FOOD#STYLE_OPTIONS
Kesinlikle tavsiye etmiyorum.	RESTAURANT#GENERAL
DiÄŸer ÅŸubesinin efsaneleÅŸen hikayelerinin ardÄ±ndan defalarca hep belirli sebeplerle geldiÄŸimiz Eleos bence cidden abartÄ±lÄ±yor.	RESTAURANT#GENERAL
YeÅŸilkÃ¶y ÅŸubesini bilemem ama burasÄ± standart Ã¼zerinde yine de o fiyatlar bence Ã§ok saÃ§ma.	RESTAURANT#PRICES
AyrÄ±ca fix menÃ¼ zorlamasÄ± gibi en sinir bozucu uygulamayÄ± burada normalleÅŸtirmiÅŸ durumdalar.	FOOD#STYLE_OPTIONS
Mezeler de vasatÄ±n Ã¼zerinde.	FOOD#QUALITY
Balkon/teras bÃ¶lÃ¼mÃ¼ de cidden Ã§ok kÃ¼Ã§Ã¼k.	AMBIENCE#GENERAL
Yine de AsmalÄ±mescit bÃ¶lgesindeki meyhanelere gÃ¶re daha fazla tercih edilir bir mekan.	
Her zaman gittigim ve servisi her zaman igrenc olan bu mekan artiik iyice rezalet sinirlarini zorlamis.	SERVICE#GENERAL RESTAURANT#GENERAL
Mekanin isletmecisi beyin tavri tarzi konusmasi uslubu ve terbiyesi yerlerde.	SERVICE#GENERAL SERVICE#GENERAL
Mekanin populerligi yuzunden rahatlar sanirim ama bu rahatlikla populerligi kisa surede kaybederler.	RESTAURANT#GENERAL
Istanbulda tek manzara goren yer olmamakla beraber yemekleride son derece lezzetsiz.	AMBIENCE#GENERAL FOOD#QUALITY
Zaten bu saatten sonra sultan sofrasida kursa o isletmeciyle bu mekana bir daha adimimi atmam.	SERVICE#GENERAL
Yemekler super lezzetli, ogle yemeginde cok kalabalik ama saat 2 sonrasinda rahat.	FOOD#QUALITY AMBIENCE#GENERAL
Bir tabaga 5 farkli cesit isteyebilirsiniz, ozellikle bugday salatasi ve havuc salatasi muhtesem mutlaka deneyin	FOOD#QUALITY FOOD#QUALITY
Istanbulda baklavanÄ±n adresi.	FOOD#QUALITY
KarakÃ¶yden, EminÃ¶nÃ¼nden geÃ§erken uÄŸramalÄ±sÄ±nÄ±z.	RESTAURANT#GENERAL
Sadece baklava deÄŸil karÄ±ÅŸÄ±k tabak yaptÄ±rÄ±n.	FOOD#QUALITY
Ã‡ikolatalÄ± baklavayÄ±da Ã¶zellikle bayanlara tavsiye ederim	FOOD#QUALITY
yurtdisindan gelen misafirlerimi memnun etmesiyle,manzarasiyla ve tabii ki meze ve yemekleriyle begenimi kazanmis oldu gelinir tadilir calan muzikler guzel ayari sohbetle hos bir fon oluyor.	AMBIENCE#GENERAL FOOD#QUALITY AMBIENCE#GENERAL
Burayi seviyorum gerÃ§ekten.	RESTAURANT#GENERAL
ortaya karisik sÃ¶ylerseniz herseyin tadina bakabilirsiniz.	
Hersey lezzetli statÃ¼sÃ¼ne Ã§ok yakin.	FOOD#QUALITY
Keyifli vakit geÃ§irirsiniz emin olun.	RESTAURANT#GENERAL
Bira dÄ±ÅŸÄ±nda baÅŸka bir ÅŸey iÃ§menizi istemeyen mekan, bira 7,8 lira iken votka 25, ÅŸarap 17.5...	DRINKS#PRICES DRINKS#PRICES
Onun dÄ±ÅŸÄ±nda, belirli bir saatten sonra mÃ¼zik saÄŸÄ±r edici seviyeye ulaÅŸmakta.	AMBIENCE#GENERAL
BalÄ±klarÄ±ndan daha Ã§ok kendine has mezeleriyle Ã¶n plana Ã§Ä±kmÄ±ÅŸ AlkolsÃ¼z bir BalÄ±kÃ§Ä± .	FOOD#STYLE_OPTIONS
mezeleri gerÃ§ekten standartlarÄ±n Ã¼zerinde mekan neredeyse her gÃ¼n akÅŸam saatlerinde yoÄŸun oluyor .	FOOD#QUALITY
bunun haricinde Ã§alÄ±ÅŸanlarÄ±n ilgiside gayet iyi	SERVICE#GENERAL
Tam bir hayal kÄ±rÄ±klÄ±ÄŸÄ±.	RESTAURANT#GENERAL
Combo tabaÄŸÄ± hayalleriyle gittik ve ÅŸaka gibi iÃ§inde iki Ã¼Ã§ parÃ§a olan Ã§ok lezzetsiz bir tabak geldi.	FOOD#QUALITY
Hamburgerleri vasat.	FOOD#QUALITY
Ã‡ok Ã§ok kÃ¶tÃ¼	RESTAURANT#GENERAL
SÃ¼tiÅŸtir dedik kahvaltÄ± yapalÄ±m dedik piÅŸman olduk valla.	RESTAURANT#GENERAL
PorsiyonlarÄ± Ã§ok kÃ¼Ã§Ã¼k fiyatlar Ã§ok PahalÄ±.	FOOD#STYLE_OPTIONS AMBIENCE#GENERAL
Garsonlar ilgisiz Ã§aylarÄ± kÃ¶tÃ¼.	SERVICE#GENERAL DRINKS#QUALITY
Arada bir belki tatlÄ± yemeye gidilebilir.	FOOD#QUALITY
O da manzarasÄ± iÃ§in.	AMBIENCE#GENERAL
Egzotik Ã§aylarÄ± seviyorsanÄ±z mutlaka uÄŸramanÄ±z gereken bir mekan.	DRINKS#STYLE_OPTIONS
Bourbon vanilla ve Irish Malt tavsiye ettiÄŸim Ã§aylar arasÄ±nda.	DRINKS#QUALITY DRINKS#QUALITY
Servis kaliteli, Ã§alÄ±ÅŸanlarÄ± ise inanÄ±lmaz ilgili.	SERVICE#GENERAL SERVICE#GENERAL
SevdiÄŸiniz Ã§aylarÄ±n bazÄ±larÄ±nÄ± paket olarak satÄ±n alabiliyorsunuz da.	DRINKS#STYLE_OPTIONS
Mekandaki mÃ¼zik seÃ§imleri de harika.	AMBIENCE#GENERAL
Bazen inanÄ±lmaz kalabalÄ±k olabiliyor haliyle Ã¶yle gÃ¼nlerde serviste aksaklÄ±klar yaÅŸanabiliyor.	SERVICE#GENERAL
Mekan gÃ¼zel ferah.	AMBIENCE#GENERAL
Servis Ã§ok hÄ±zlÄ±.	SERVICE#GENERAL
Ã‡ok fazla Ã§eÅŸit var.	FOOD#STYLE_OPTIONS
BazÄ± Ã§eÅŸitler kebapla Ã§ok alakasÄ±z olabiliyor.	FOOD#STYLE_OPTIONS
FiyatlarÄ± makul.	RESTAURANT#PRICES
Yemekler lezzetli	FOOD#QUALITY
Manzara gÃ¼zel,yemekler gÃ¼zel ama servis berbat.	SERVICE#GENERAL FOOD#QUALITY AMBIENCE#GENERAL
Bir defa demlik Ã§ay iÃ§mek istedik musluk suyu ile yapmÄ±ÅŸlar kÃ¼f kokuyordu.	DRINKS#QUALITY
Sonra deÄŸiÅŸtirip damacana suyu ile yaptÄ±lar.	
KÄ±sacasÄ± berbat.	RESTAURANT#GENERAL
Sahura arkadaslarla gittik.	
AÃ§ik bÃ¼fe sahurdu.	
Mekani Ã§ok gÃ¼zel, Ã§esitler inanilmaz derecede bol ve lezzetli.	FOOD#QUALITY AMBIENCE#GENERAL FOOD#STYLE_OPTIONS
servisi gayet iyi.	SERVICE#GENERAL
Tesis, Fethi Pasa korulugunun iÃ§inde yer aliyor.	LOCATION#GENERAL
Etler kalitesi ortalama.	FOOD#QUALITY
Lezzet ortalama.	FOOD#QUALITY
Neyle kÄ±yaslanarak Ã§ok beÄŸenildiÄŸini merak ediyorum aÃ§Ä±kÃ§asÄ±.	RESTAURANT#GENERAL
Mekan gÃ¼zel.	RESTAURANT#GENERAL
Bu et bu parayÄ± asla hak etmiyor.	FOOD#QUALITY FOOD#PRICES
NasÄ±l ve neden bilmiyorum Florya Åazeli'de etin daha lezzetli olduÄŸu sÃ¶yleniyor.	
Oraya da gidip tadacaÄŸÄ±m.	
Kuru fasulye iÃ§in gidilir.	FOOD#QUALITY
GÃ¼zel yapÄ±yorlar.	FOOD#QUALITY
Pilav, ayran eÅŸliÄŸinde iyi bir menÃ¼.	FOOD#QUALITY
Ama servis konusunda personelinden memnun deÄŸilim, bu konuda kendilerini inÅŸ.	SERVICE#GENERAL
deÄŸiÅŸtirirler	
Mart ayinin son gunu bugun berbatti burasi.	RESTAURANT#GENERAL
Kahvaltiliklar geldi cay yok gelen menemen bozuk domatesten,kokusu tadi yenecek gibi degil, yan masada surekli onu istemistik biz gelmedi diyip durdu bizim gibi.	FOOD#QUALITY FOOD#QUALITY FOOD#STYLE_OPTIONS
Normalde sevdigim bir kahvalticiydi bgn ne yedigimi anladim ne bisi!	FOOD#QUALITY
Nereye gitsek kararsÄ±zlÄ±ÄŸÄ±na dÃ¼ÅŸmek Ã¼zereyken kurtarÄ±cÄ± olan mekandÄ±r KÃ¼tÃ¼k Ev.	RESTAURANT#GENERAL
Ä°Ã§eriden ve dÄ±ÅŸarÄ±dan tamamen bir daÄŸ evini andÄ±rmasÄ±yla egzotik bir havaya sahip olan mekanda servis nispeten hÄ±zlÄ±, fiyatlar pahalÄ± deÄŸil, bahÃ§esi gÃ¼zel.	AMBIENCE#GENERAL AMBIENCE#GENERAL RESTAURANT#PRICES SERVICE#GENERAL
KÄ±ÅŸÄ±n daha Ã§ok tercih edilebilecek bir yer ama yazÄ±n da gidilir gidilmesine.	RESTAURANT#GENERAL
Sunduklari lezzetleri ve gÃ¶sterdikleri ilgi ile KÃ¼Ã§Ã¼k Ev sayesinde gÃ¼zel bir aksam geÃ§irdik.	FOOD#QUALITY RESTAURANT#GENERAL SERVICE#GENERAL
Ardindan en Ã§ok begendigim ise dÃ¶ner oldu.	FOOD#QUALITY
Gayet lezzetliydi.	FOOD#QUALITY
Bence buraya yolunuz dÃ¼serse dÃ¶nerini ve kavurmali pidesini kesinlik denemenizi Ã¶neririm.	FOOD#QUALITY
Diger yediklerimizide begendim hepsi gÃ¼zellerdi.	FOOD#QUALITY
Kendi Ã¼retimleri manda yogurtlarinida denemenizde fayda var.	FOOD#QUALITY
Tatlilardan ise en Ã§ok kazandibini ve kaymakli ayva tatlisini begendim.	FOOD#QUALITY FOOD#QUALITY
Fiyatlar ise sunulan hizmet, kalite ve merkezi konumundan dolayi uygun sayilir.	RESTAURANT#PRICES LOCATION#GENERAL SERVICE#GENERAL
Son resimde menÃ¼ iÃ§erigini gÃ¶rebilirsiniz.	
Ã–ncelikle ortamini Ã§ok begendim.	AMBIENCE#GENERAL
GÃ¼zel, sik ve ferah bir ortami var.	AMBIENCE#GENERAL
Ã–zellikle restorantin tam ortasindaki agaÃ§ Ã§ok hosuma gitti.	AMBIENCE#GENERAL
Bence asla kesilmemesi lazim.	
O agaci korumak iÃ§in gÃ¶sterdiginiz Ã§aba kesinlikle isletmenizin sayginligini fazlasiyla arttiracaktir.	AMBIENCE#GENERAL
Hazir Ã¼rÃ¼nlerden Ã§ok yÃ¶resel ve kendi Ã¼retimleri Ã¼rÃ¼nleri kullaniyor oluslari Ã§ok hosuma gitti.	FOOD#STYLE_OPTIONS
Trabzon ve Rizeden gelen kavurmalar ile yapilan kasarli ve kavurmali pide beni benden aldi.	FOOD#QUALITY
Harikaydi...	RESTAURANT#GENERAL
Umdugumu degil buldugumu yedim - Arkadaslarim Ã§ok Ã¶vdÃ¼, geldim yedim bitiremedim.	FOOD#QUALITY
Yani gÃ¼zel degildi.	FOOD#QUALITY
Damak tadima hitap edemedi aÃ§ikÃ§asi.	FOOD#QUALITY
Biberler kizartilmadan atilmis iÃ§ine.	FOOD#QUALITY
Bol yumurtali ve birkaÃ§ parÃ§a domates atilmis iÃ§ine.	FOOD#QUALITY
Adeta menemen degil biberli omlet olmus gibi.	FOOD#QUALITY
AÃ§ik ayrani fena degildi.	DRINKS#QUALITY
Begendim diyebilirim.	RESTAURANT#GENERAL
Manzara disinda deneyimlenecek bir yemegi yok gereksiz pahali ve verdiginiz paraya asla degmeyen menusu var aslinda yok cunku cesit yok.	AMBIENCE#GENERAL FOOD#STYLE_OPTIONS RESTAURANT#PRICES FOOD#QUALITY
hamburgerini deneyelim dedik kendisi 35tl sunum berbat hamburgeri lezzetli degil saoganlar karamelize degil sadece patates kizartmasi guzel onu da mc donaldsta yeyin.	FOOD#QUALITY SERVICE#GENERAL FOOD#QUALITY
dÃ¼n gidip yeniden kahvalti etme firsati buldugum yer.	RESTAURANT#GENERAL
iki kisi olarak bir kahvalti tabagina ek bir sepet patates ve bir menemen sÃ¶yledik.	
ben arkadasim ve 2.5 yasindaki oglum rahatlikla doyduk.	FOOD#STYLE_OPTIONS
bir kahvalti tabagi ile gelen Ã§ay Ã¼cretsizdi.	DRINKS#STYLE_OPTIONS
yukaridaki masaya ek olarak 3 bardak Ã§ay ve su dahil 42 tl Ã¼cret Ã¶dedik.	RESTAURANT#PRICES
kahvalti tabagi 17.90 tl menemen 10 tl patates 8 tl.	FOOD#PRICES FOOD#PRICES FOOD#PRICES
Sani Istanbul'un dÃ¶rt bir kÃ¶sesine yayilmis durumda.	RESTAURANT#GENERAL
Fakat benim Ã§ok yakinimda olmasina ragmen Ã§ok sik gitmeyi tercih etmiyorum.	RESTAURANT#GENERAL
Etine eyvallah fakat fiyat konusunda Ã§ok uÃ§uklar.	RESTAURANT#PRICES FOOD#QUALITY
Biraz daha ortamini sik hale dÃ¶nÃ¼stÃ¼rÃ¼rlerse daha fazla mÃ¼steri Ã§ekeceklerine eminim.	AMBIENCE#GENERAL
Bu kadar Ã§ok ve lezzetli Ã§ay Ã§eÅŸidini bir arada bulmak Ã§ok gÃ¼zel.	FOOD#QUALITY FOOD#STYLE_OPTIONS
KarakÃ¶yÃ¼n dar sokak aralarÄ±nda, sokaÄŸa koyduÄŸu masalarÄ±yla insanÄ± farklÄ± bir atmosfere sÃ¼rÃ¼klÃ¼yor.	AMBIENCE#GENERAL LOCATION#GENERAL
Servis Ã§ok Ã¶zenli ve gÃ¼zel.	SERVICE#GENERAL
MÃ¼ÅŸterisi genÃ§ bir kitle.	RESTAURANT#GENERAL
KÃ¼l tablalarÄ±nÄ±n dolu ve pis durmasÄ± bana Starbucks'Ä± hatÄ±rlattÄ±.	SERVICE#GENERAL
Manzara'ya tabikide yÄ±ldÄ±zlÄ± 5 !	AMBIENCE#GENERAL
Dekorasyon da bir o kadar gÃ¼zel.	AMBIENCE#GENERAL
EÄŸer sabÄ±rlÄ±ysanÄ±z ve denize biraz daha yakÄ±n olayÄ±m diyorsanÄ±z iyi ÅŸanslar ne kadar bekleyeceÄŸiniz bir muamma.	RESTAURANT#GENERAL
Tek kÃ¶tÃ¼ yanÄ± bu olabilir burasÄ±nÄ±n benim aÃ§Ä±mdan.	RESTAURANT#GENERAL
Fiyatlar gerÃ§ekten bir tÄ±k Ã¼stte ama manzara gÃ¶zÃ¼mÃ¼ her defasÄ±nda kÃ¶r ediyor ve gÃ¶rmezden gelebiliyorum.	AMBIENCE#GENERAL RESTAURANT#PRICES
AÅŸk-Ä± Memnu'yu tatmayan kalmasÄ±n!	FOOD#QUALITY
BurdaysanÄ±z mutlaka deneyin KuÅŸ YuvasÄ± yenmesi biraz zor bir tatlÄ± ama o da gÃ¼zel bir alternatif.	FOOD#QUALITY
yazÄ±n dÄ±sarÄ±da yer bulmasÄ± epey zor.	AMBIENCE#GENERAL
fakat kÄ±zartma combosu bir harika.	FOOD#QUALITY
sÃ¼rekli kalabalik nedeniyle servis oldukca yavas.	SERVICE#GENERAL
bazen bir hesabÄ±n gelmesi bile yarÄ±m saat sÃ¼rebiliyor.	SERVICE#GENERAL
Sadece Ã¼n yapmak iÅŸte hepsi bundan ibaret.	RESTAURANT#GENERAL
ParasÄ±yla almÄ±yormuÅŸ gibi davran panpa konsept esinmesi bÃ¼lent ersoyun fevkinde	AMBIENCE#GENERAL
3 arkadaÅŸ yaz baÅŸÄ± gittik,dÃ¶ner kÄ±sma oturduk 7-8 dakika sipariÅŸ almaya gelen olmadÄ±.	SERVICE#GENERAL
MasalarÄ± silen bir personel vardÄ± bakarmÄ±sÄ±nÄ±z dedik,baktÄ± ama bakmasamÄ±ydÄ±.	
Bi dakka bekleyin iÅŸim var gÃ¶rÃ¼yorsunuz tarzÄ± bir fÄ±rÃ§a.	SERVICE#GENERAL
Evet yemekler lezzetli ortam guzel fakat hafta sonu gittigimiz icin midir bilmemm cok kalabalikti.	AMBIENCE#GENERAL FOOD#QUALITY
Calisanlar pek ilgili degildi hesabi tam 17482 garsona soylememize ragmen yarim saat sonra geldi abartisiz.	SERVICE#GENERAL SERVICE#GENERAL
iÃ§ecek Ã§eÅŸitliliÄŸi konusunda biraz yetersiz ancak fiyat olarak tartÄ±ÅŸmasÄ±z Ã§evresine gÃ¶re Ã§ok Ã§ok ucuz.	RESTAURANT#PRICES DRINKS#STYLE_OPTIONS
civarda sÄ±caktan bunalÄ±p serinlemek istiyorsanÄ±z boÄŸazÄ±n kenarÄ±ndaki masalardan birine oturup canlÄ± mÃ¼zik eÅŸliÄŸinde soÄŸuk birÅŸeyler iÃ§ebilirsiniz.	RESTAURANT#GENERAL
TÃ¼rk kahvesi de fena deÄŸil.	DRINKS#QUALITY
Manzarasi ve dizayni guzel fakat garsonlar ilgisiz, porsiyonlar cok kucuk ve pahali.	AMBIENCE#GENERAL FOOD#STYLE_OPTIONS SERVICE#GENERAL RESTAURANT#PRICES
Arap turistlerin ugrak mekani.	
Lezzet eh iste.	FOOD#QUALITY
Ozetle manzara disinda bisey yok.	AMBIENCE#GENERAL RESTAURANT#GENERAL
Happy hour icin vazgecilmez nokta.	RESTAURANT#GENERAL
Bence burgerleri ve pizzasi Kanyon'da yenebilecek acik ara en iyi.	FOOD#QUALITY
Zincirler icinde tek tercih edilebilir yer.	RESTAURANT#GENERAL
Adi her ne kadar pizzaci olsa da ne yazik ki pizzalar ortalama.	FOOD#QUALITY
Neden bu kadar popÃ¼ler oldugunu anlamiyorum.	RESTAURANT#GENERAL
Hatta bazi pizzalarda dominosun benzerleri tercih edilebilir.	
Num Num gerÃ§egi - Yediginiz herseyin hakkini verdikleri bir gerÃ§ek.	FOOD#QUALITY
Yemeklerin doyuruculugu ve lezzeti tartisilmaz ancak Ã¶gle saatlerinde yer bulmakta oldukÃ§a sikintili.	FOOD#QUALITY AMBIENCE#GENERAL
Manzaraya da sufleye de bayildik.	AMBIENCE#GENERAL FOOD#QUALITY
Karsida isiklariyla Rumeli Hisari ve kÃ¶prÃ¼ manzarasi esliginde bir aksamÃ¼stÃ¼ Big Chefs'te oturmak Ã§ok keyifliydi.	AMBIENCE#GENERAL AMBIENCE#GENERAL
Sufle 13,5 lira, Ã§ay 4,5 lira.	DRINKS#PRICES FOOD#PRICES
Levent Ã§arsinin iÃ§inde bulunan express daha genÃ§ bir gÃ¶rÃ¼nÃ¼me sahip.	
Ã–zellikle paket servisi iÃ§in aÃ§ilmis.	
Burada sulu yemek yok.	FOOD#STYLE_OPTIONS
GenÃ§ler ve Ã¶grenciler iÃ§in fiyatlari daha uygun tutmuslar.	RESTAURANT#PRICES
Lahmacun dÃ¶ner burger pide ve kÃ¶fte Ã§esitleri mevcut.	FOOD#STYLE_OPTIONS
Iftar menÃ¼sÃ¼ 80 TL.	FOOD#PRICES
Ezogelin Ã§orba Ã§ok tuzluydu.	FOOD#QUALITY
Ve erken servis edildigi iÃ§in iftara kadar sogudu.	SERVICE#GENERAL
IÃ§li kÃ¶fte ve pirzola gÃ¼zeldi.	FOOD#QUALITY
Servis elemanlari yetersiz oldugu iÃ§in yavasti.	SERVICE#GENERAL
Her seyden Ã¶te bÃ¶yle bir mekana bu tuvaletler hiÃ§ yakismiyor	AMBIENCE#GENERAL
Bir yer dÃ¼ÅŸÃ¼nÃ¼n ki iÃ§ecekler bardakla geliyor, garsonlar suratsÄ±z ve Islak mendil bulunmuyor sebepsiz yere -_- buraya ne olmuÅŸ bÃ¶yle !	DRINKS#STYLE_OPTIONS SERVICE#GENERAL
Hayal kÄ±rÄ±klÄ±ÄŸÄ±	RESTAURANT#GENERAL
Bir kaÃ§ kez yemek yeme fÄ±rsatÄ± bulduÄŸum mekan.	
Civardaki restorantlardan pek bir farkÄ± yok, servisi yavaÅŸ.	SERVICE#GENERAL
Fiyatlar da aynÄ± ÅŸekilde civardakilerle hemen hemen aynÄ±.	
Her deniz Ã¼rÃ¼nÃ¼nÃ¼ karÄ±ÅŸtÄ±rÄ±p Ã¶nÃ¼nÃ¼ze getiriyorlar.	FOOD#STYLE_OPTIONS
AÃ§Ä±kÃ§asÄ± hicbirinin tadÄ±nÄ± tam alamiyorsunuz.	FOOD#STYLE_OPTIONS
Balik ve deniz Ã¼rÃ¼nlerini Ã§ok sevmeyenler Balik KFCsi kÄ±vamÄ±nda olduÄŸu ve KÄ±zartma bol olduÄŸu iÃ§in sevebilirler.	FOOD#STYLE_OPTIONS
Sadece soya soslu somon baÅŸarÄ±lÄ±ydÄ±.	FOOD#QUALITY FOOD#QUALITY
Kisin iÃ§ kismi dag evini animsatan, yazin bahÃ§esi yesillikler icersinde ve ferah olan, aÃ§ik bÃ¼fe kahvaltisi zengin Ã§esitleriyle bir hayli rabet gÃ¶ren, bunun haricinde genellikle nargile severlerin ugrak mekani olan tatli bir cafe.	RESTAURANT#GENERAL AMBIENCE#GENERAL FOOD#STYLE_OPTIONS
Utanmadan bozuk iÃ§li kÃ¶fte, acilasmis tereyagi servis edebilen bir mekan...	FOOD#QUALITY FOOD#QUALITY
Garsonu bu kadar uyardigimizda ise sadece iletirim dedi.	SERVICE#GENERAL
Ã–zÃ¼r bile dilemediler.	SERVICE#GENERAL
Machiato dediÄŸim halde yerine espresso servis eden iÅŸletme.	SERVICE#GENERAL
BoÅŸ bardak, fincan, tabak masada bekliyor, toplayan yok.	SERVICE#GENERAL
MenÃ¼deki Ã§eÅŸitleri sorunca, o yok, bu yok, onun yerine ÅŸunu verelim, bunu verelim.	FOOD#STYLE_OPTIONS
Kirli, iyi yÄ±kanmamÄ±ÅŸ bardakla Ã§ay servisi.	SERVICE#GENERAL
Mado'nun genel hastalÄ±klarÄ±nÄ±n bir araya gelmiÅŸ hali gibi.	RESTAURANT#GENERAL
Manzara satÄ±yor burada da.	RESTAURANT#GENERAL AMBIENCE#GENERAL
Yoksa Mado'larÄ±n kÃ¶tÃ¼ bir Ã¶rneÄŸi.	RESTAURANT#GENERAL
HaklarÄ±nÄ± yemeyelim, iki gÃ¼nlÃ¼k gazete bulup okuyabildik.	
Ev yemekleri hergÃ¼n farkli - Tipki anne eli degmis gibi lezzetli ev yemekleri...	FOOD#QUALITY FOOD#STYLE_OPTIONS
Mekan Ã§ok kÃ¼Ã§Ã¼k hemen doluyor.	AMBIENCE#GENERAL
Ã–glenleri yer bulamadigimiz Ã§ok oluyor.	SERVICE#GENERAL
Genelde Ã¼rÃ¼nler lezzetli ve fiyat da uygun .	FOOD#QUALITY FOOD#PRICES
Ã–glen iÃ§in tercih edilebilir ama 12yi Ã§ok geÃ§irmemek gerekiyor...	SERVICE#GENERAL RESTAURANT#GENERAL
Cok guzel sirin bir mekan yemekler kokteyliler super manzara cok iyi, tabiki bu guzel seyler icin sira bekleyebilirsiniz.	AMBIENCE#GENERAL FOOD#QUALITY DRINKS#QUALITY AMBIENCE#GENERAL
MantarlÄ± pizzaya ( porchini ve kestane) sucuk eklettim.	
Malzemeler gÃ¼zel ama hamuru Ã§ok sevemedim.	FOOD#STYLE_OPTIONS FOOD#STYLE_OPTIONS
Sanki hazÄ±r gibi geldi.	
Genel olarak mekan ÅŸirin.	AMBIENCE#GENERAL
Fiyatlar upper crust ayarÄ±nda ama lezzet ve Ã¶lÃ§Ã¼ farklÄ±.	
KarÅŸÄ±laÅŸtÄ±rÄ±rsak; bence upper crust hamur ve Ã¶lÃ§Ã¼ olarak daha iyi.	
Alkol olsa daha tutulabilirler.	DRINKS#STYLE_OPTIONS
Ã‡Ã¼nkÃ¼ bulunduklarÄ± lokasyonda rakip Ã§ok.	
HayatÄ±mÄ±n en pahalÄ± yemeÄŸini yediÄŸim restoran.	FOOD#PRICES
Yemekler lezzetli olmasÄ±na raÄŸmen FSM kÃ¶prÃ¼sÃ¼nÃ¼n baÅŸÄ±nÄ±zÄ±n Ã¼stÃ¼nde zebellah gibi durmasÄ± manzaranÄ±n keyfini kaÃ§Ä±rmakta.	AMBIENCE#GENERAL FOOD#QUALITY
Yemek porsiyonlarÄ± Ã§ok kÃ¼Ã§Ã¼k.	FOOD#STYLE_OPTIONS
Vale hizmeti var.	SERVICE#GENERAL
HayatÄ±nÄ±zda bir defa gidilebilecek bir yer.	
Rock'n Roll burger yedim.	FOOD#QUALITY
Burger ekmegi yumusamis dagiliyordu.	FOOD#QUALITY
Icinde ki sos da pek bi istah acici degildi.	FOOD#QUALITY
Ortami guzel gidilecekse onun icin gidelebilir.	AMBIENCE#GENERAL
Mekan enteresan bir havaya sahip , haftaici aksamlari abiler ellerinde nargilelerle Ã§ayla muhabbetin dibine vururken.	AMBIENCE#GENERAL
Hafta sonu sabahlari ozellikle evli ve cocuklu ciftlerin kahvalti merkezi oluyor.	RESTAURANT#GENERAL
Yemeklerini ve caylarini begendigim.	FOOD#QUALITY DRINKS#QUALITY
Fiyat olarak gayet mantikli bir isletme.	RESTAURANT#PRICES
Tavsiyemdir	RESTAURANT#GENERAL
Kendilerine Ã¶zel biralarÄ± mevcut olsaydÄ± belki daha gÃ¼zel olurdu ama standart biralardan iÃ§mek durumunda kaldÄ±k.	DRINKS#STYLE_OPTIONS
Bunun haricinde servis iyi garsonlar gÃ¼leryÃ¼zlÃ¼ ve rahat bir mekan.	SERVICE#GENERAL SERVICE#GENERAL AMBIENCE#GENERAL
Yemekler de farklÄ± tadlar var.	FOOD#STYLE_OPTIONS
Cuma iÅŸ Ã§Ä±kÄ±ÅŸÄ± arkadaÅŸlarla takÄ±lmalÄ±k bir mekan.	AMBIENCE#GENERAL
Ã‡ok fazla lezzetli alternatifi bulunan menÃ¼sÃ¼nÃ¼ seviyorum.	FOOD#STYLE_OPTIONS FOOD#QUALITY
Citys'in alt katÄ±ndayken tanÄ±dÄ±k sevdik.	RESTAURANT#GENERAL
Magnolia'sÄ± ayrÄ±, limonatasÄ± ayrÄ± gÃ¼zel.	FOOD#QUALITY DRINKS#QUALITY
Bir peynirli tostu bile Ã§ok Ã¶zenle sunuyorlar.	SERVICE#GENERAL
Somon Ä±zgarasÄ±na 4 puan.	FOOD#QUALITY
Hem saÄŸlÄ±klÄ± hem de doyurucu.	FOOD#QUALITY
GÃ¼zel bir Ã¶ÄŸle yemeÄŸi molasÄ±.	FOOD#QUALITY
BahÃ§esi de gÃ¼zel.	AMBIENCE#GENERAL
SalÄ±ncaÄŸÄ± bile var.	AMBIENCE#GENERAL
Yemek Ã¼zerine de soÄŸuk kahve iyi gidiyor.	DRINKS#QUALITY
BoÄŸazÄ±n en gÃ¼zel yerlerinden birinde, sÄ±cak, sempatik ve zevkli dekorasyonu ve ÅŸahane manzarasÄ±, genÃ§ mÃ¼ÅŸteri kitlesi, gÃ¼zel mÃ¼zikleri yetmezmiÅŸ gibi gÃ¼ler yÃ¼zlÃ¼ arkadaÅŸca servisi de mÃ¼kemmel.	AMBIENCE#GENERAL SERVICE#GENERAL LOCATION#GENERAL AMBIENCE#GENERAL AMBIENCE#GENERAL
KahvaltÄ± seÃ§enekleri Ã§ok iyi.	FOOD#STYLE_OPTIONS
Yemekleri de fena deÄŸil.	FOOD#QUALITY
TÃ¼m bu Ã¶zelikleri gÃ¶z Ã¶nÃ¼ne alÄ±nca fiyatlar Ã§ok makul geliyor.	RESTAURANT#PRICES
Gece, gÃ¼ndÃ¼z, her zaman iÃ§in Ã¶neririm.	RESTAURANT#GENERAL
Ã–zellikle yaz aylarÄ±nda.	
Besiktaki en hakiki pideci diyebilirim.	FOOD#QUALITY
ben bu yuzden tatli yemegi tercih etmedim.	FOOD#QUALITY
fiyatlari 13-17 tl arasi porsiyonlari 1.5 olarak buyutmek de mumkun.	FOOD#PRICES FOOD#STYLE_OPTIONS
puanimdan sirf yavas yuzunden kisiyorum!	SERVICE#GENERAL RESTAURANT#GENERAL
otobus duraginin hemen karsisinda yeri cok kolay.	LOCATION#GENERAL
kucuk ama hep dolu olan bir pideci.	
porsiyonu tam malzemesi bol hamuru citir citir fakat servis icin ayni hosnutluktan bahsedemicem.	FOOD#STYLE_OPTIONS FOOD#STYLE_OPTIONS FOOD#STYLE_OPTIONS SERVICE#GENERAL
servis oldukca yavas.	SERVICE#GENERAL
yavas demek bile az kalir.	SERVICE#GENERAL
az vaktiniz varsa kesinlikle ogle saatlerinde ugramayiniz.	SERVICE#GENERAL
besiktas da yiyebilceniz en iyi pide ama odun atesinde pisenin yerini tutmuyor tabiki.	FOOD#STYLE_OPTIONS FOOD#QUALITY
tatli secenekleri de mevcur sufle ve kunefe var menu de var da pide o kadar gec gelince insani tatli siparisi dusunduruyor.	SERVICE#GENERAL FOOD#STYLE_OPTIONS
Eski kalitesinde olmasada hala iyi diyelim talep Ã§ok olunca ister istemez kalite ve servis vasata dÃ¼ÅŸÃ¼yor etleri kenfi Ã§iftliklerinden otopark sorun fiatlar normal	SERVICE#GENERAL SERVICE#GENERAL RESTAURANT#PRICES RESTAURANT#GENERAL
Manzarasi icin gidilesi cafe , cok fazla yazacak bisey yok.	AMBIENCE#GENERAL
fiyatlar standart seviyede.	RESTAURANT#PRICES
otopark sorunu yok.	LOCATION#GENERAL
sessiz sakin ve huzurlu bir mekan.	AMBIENCE#GENERAL
Kuru fasulyesi lezzetli.	FOOD#QUALITY
Sutlaci tavsiye edilir.	FOOD#QUALITY
KÃ¶ftesi de kaliteli.	FOOD#QUALITY
Sade gÃ¼zel bir yer.	AMBIENCE#GENERAL
Ã‡alÄ±ÅŸanlar ilgili kibar.	SERVICE#GENERAL
OrtakÃ¶ye yolu dÃ¼ÅŸen ugramali.	RESTAURANT#GENERAL
Park sorunu ciddi.	LOCATION#GENERAL
Valesi var gerÃ§i.	SERVICE#GENERAL
Pazar sabahlarÄ± brunch dÄ±ÅŸÄ±nda seÃ§eneÄŸiniz yok.	FOOD#STYLE_OPTIONS
Brunch Ã§eÅŸitleri ehh.	FOOD#STYLE_OPTIONS
Masaya istenen sucuklu yumurtanÄ±n sucuÄŸuna extra Ã¼cret istenmesi ayÄ±p.	FOOD#PRICES
MekanÄ±n lokasyonu on numara ama rezervasyonsuz deniz kenarÄ± masa bulmanÄ±z imkansÄ±z.	LOCATION#GENERAL
BÃ¶yle bir brunch iÃ§in 59TL, 4 ince dilim sucuk iÃ§in 5TL extra Ã¼cret mÃ¢nÃ¢sÄ±z.	FOOD#PRICES FOOD#PRICES
HisarÃ¼stÃ¼'ndeki diÄŸer mekanlara nazaran bÃ¼yÃ¼k olmasÄ±yla fark yaratÄ±yor ama eÄŸer kalabalÄ±k bir grup deÄŸilseniz, HisarÃ¼stÃ¼'ndeki diÄŸer yerleri tercih edebilirsiniz.	
En son kabalÄ±k bir grup halinde gittiÄŸimizde sipariÅŸlerde karÄ±ÅŸÄ±klÄ±k olmuÅŸtu malesef.	SERVICE#GENERAL
Tek kelimeyle muhtesem bir lezzet, doner kesimi tam olarak usta isi.	FOOD#STYLE_OPTIONS FOOD#QUALITY
Yagsiz ve cok lezzetli.	FOOD#QUALITY
Yaninda getirdikleri tandir lavasi ise bugune kadar yedigim en lezzetli lavas.	FOOD#QUALITY
Oturdugunuz gibi siparisiniz aliniyor ve hemen servis yapilmaya baslaniyor.	SERVICE#GENERAL
Ortaya ise salata ve patates kizartmasi getiriyolar.	FOOD#STYLE_OPTIONS
Acik ara en iyi donerci.	RESTAURANT#GENERAL
Big chefs her daim ÅŸiÅŸirilmiÅŸ bir kafedir.	RESTAURANT#GENERAL
Ã‡Ã¼nkÃ¼ size oluru olmayan fiyatlar sunar.	RESTAURANT#PRICES
Bunun yanÄ± sÄ±ra ÅŸube aÃ§tÄ±ÄŸÄ± semtler ortadadÄ±r.	
Ä°sim yapmÄ±ÅŸtÄ±r Ã§Ã¼nkÃ¼ pahalÄ± olduÄŸu iÃ§in kaliteli algÄ±sÄ± yaratÄ±r .	RESTAURANT#PRICES
Bir ayvalÄ±k tostuna 20 tl , bir kavanoz tatlÄ±ya 20 tl vs. Yazan bu mekana kesinlikle gitmem .	FOOD#PRICES FOOD#PRICES RESTAURANT#GENERAL
Ã‡Ã¼nkÃ¼ bu israftan baÅŸka bir ÅŸey deÄŸil benim nazarÄ±mda .	RESTAURANT#GENERAL
BÃ¶yle mekanlarÄ± biraz boÅŸ bÄ±rakmak lazÄ±m ki Fiyat skalasÄ±nÄ± biraz dÃ¼ÅŸÃ¼k aralÄ±ÄŸa taÅŸÄ±sÄ±nlar !	RESTAURANT#PRICES
Tatlilar - Tatlilari Ã§ok gÃ¼zel, tiramisu Ã¶zellikle yenilmeli ama ana Ã¶gÃ¼n kadar bÃ¼yÃ¼k geliyor dikkat!	FOOD#QUALITY FOOD#QUALITY
Unsuz Ã§ikolatali pastasi biraz agir, diyet yapanlar bulasmasin!	FOOD#QUALITY
Yemeklerin tadi tuzu yok.	FOOD#QUALITY
Ortam gÃ¼rÃ¼ltÃ¼den ibaret.	AMBIENCE#GENERAL
Garsonlar TV izlemekten size bakmiyor.	SERVICE#GENERAL
GeÃ§in allahaskina baska bir sÃ¼rÃ¼ yer var yenebilecek	RESTAURANT#GENERAL
GÃ¼zel - Konum olarak Ã§ok keyifli bir yer degil ancak Ã§alisirken Ã¶gle yemekleri iÃ§in bazen gidiyoruz.	LOCATION#GENERAL FOOD#QUALITY
Yemeklerin lezzetine inanamayacaksiniz, pastirma ile yapilan Topkapi kebabi Ã§ok iyidir.	FOOD#QUALITY FOOD#QUALITY
Koftenin hicbir ozelligi yok.	FOOD#QUALITY
Hizmet yok guleryuz yok.	SERVICE#GENERAL SERVICE#GENERAL
Manzaranin ekmegini yiyorlar.	RESTAURANT#GENERAL AMBIENCE#GENERAL
Masalar dipdibe marketten dondurulmus kofte alin evinizde yiyebilirsiniz.	AMBIENCE#GENERAL
Inanin fark yok.	
Siradan - Siradan kebaplari olan mekan...	FOOD#QUALITY
Kebap iÃ§in kesinlikle gidilmeli denemez ama tatlilari inanilmaz gÃ¼zel.	FOOD#QUALITY FOOD#QUALITY
Megerse meshur Ã‡avusoglu tatlinin sahiplerimis isletmecileri.	
Hizmetten cok memnun kaldik.	SERVICE#GENERAL
Herkes cok ilgili ve guler yuzluydu.	SERVICE#GENERAL
Yogunluktan dolayi yer bulma konusunda biraz sikinti yasamis olsak da sansimiza en guzel yeri kaptik balkonda :	
D Somon izgara ve etli quesadilla sipariz ettik.	FOOD#QUALITY FOOD#QUALITY
Somon izgaranin altinda olan kuskonmazli ispanakli sote mukemmeldi, yemek ise genel olarak guzeldi.	FOOD#QUALITY FOOD#QUALITY
Etli quesadillanin ise ozellikle eti cok guzeldi.	FOOD#QUALITY
Mutlaka bir daha gelicez :	RESTAURANT#GENERAL
SevdiÄŸim bir mekan.	RESTAURANT#GENERAL
MÃ¼zikler, bahÃ§esi, menÃ¼sÃ¼ gÃ¼zel.	FOOD#STYLE_OPTIONS AMBIENCE#GENERAL AMBIENCE#GENERAL
Ferah bir ortamÄ± var ve kalabalÄ±k buluÅŸmalar iÃ§in de uygun bir yer.	AMBIENCE#GENERAL AMBIENCE#GENERAL
Ã‡alÄ±ÅŸanlarÄ± da gÃ¼ler yÃ¼zlÃ¼.	SERVICE#GENERAL
Girerken bÃ¶yle bir yerle karÅŸÄ±laÅŸacaÄŸÄ±nÄ±zÄ± tahmin etmiyorsunuz konumu nedeniyle.	LOCATION#GENERAL
SÃ¼tiÅŸ'in Emirgan ÅŸubesi gibi bu ÅŸubesinin manzarasÄ± da Ã§ok gÃ¼zel deniz hemen yanÄ±nÄ±zda kÃ¶prÃ¼ hemen saÄŸ Ã§aprazda :	AMBIENCE#GENERAL
) yemekler gÃ¼zel fiyatlar da mekana gÃ¶re gayet uygun.	RESTAURANT#PRICES FOOD#QUALITY
TavukgÃ¶ÄŸsÃ¼ baÅŸarÄ±lÄ± :	FOOD#QUALITY
Berbat biyer rezervasyon yaptirdigim halde misafirlerime rezil oldum rezalet biyer calisanlarin tavirlari olsun ilgileri herseyi rezalet otesi	RESTAURANT#GENERAL SERVICE#GENERAL
KÃ¼Ã§Ã¼k Ev Express ile mekanist etkinligi ile tanistik.	
Ã‡Ã¶mlekte ev yapimi yogurtlarini mutlaka deneyin.	FOOD#QUALITY
Eski zamanlar biraktigimiz gerÃ§ek yogurdun tadini yakalayacaksiniz.	FOOD#QUALITY
Fiyati da saka gibi.	FOOD#PRICES
3.75 TL.	
MÃ¼kellef bir yemek sonrasi ortalama 15-25 TL'ye mekandan Ã§ikabilirsiniz.	FOOD#PRICES
Dekorasyon zevkli olmus, Ã¶zellikle mekanin ortasina konuslanmis bonsai agaÃ§ beni benden aldi.	AMBIENCE#GENERAL AMBIENCE#GENERAL
Evet, bonsai hayraniyim!	
Ã‡ok iyi karsilandik ve sonuna kadar el Ã¼stÃ¼nde tutulduk.	SERVICE#GENERAL
Harikasiniz arkadaslar.	RESTAURANT#GENERAL
BÃ¶yle devam!	
) Her seyden ufak ufak tattik.	FOOD#QUALITY
Yemeklerde favorilerim dÃ¶ner ve kavurmali pide oldu.	FOOD#QUALITY
Kavurmali pide iÃ§in tekrar ugrayacagim.	FOOD#QUALITY
Tatlilarda tavuk gÃ¶gsÃ¼ gerÃ§ekten lezizdi.	FOOD#QUALITY
Irmik helvasinin da tavuk gÃ¶gsÃ¼nden eksigi yoktu, sekeri kivamindaydi ve hafifti.	FOOD#QUALITY FOOD#QUALITY
Buraya sÄ±k geliyorum, leventte Ã§alÄ±ÅŸanlarÄ±n da Ã§ok tercih ettiÄŸi bir yer.	RESTAURANT#GENERAL
Yemekleri eskiden daha gÃ¼zeldi Ã¶zellikle mantÄ±sÄ± Ã§ok baÅŸarÄ±lÄ±ydÄ±.	FOOD#QUALITY FOOD#QUALITY
Ancak her gÃ¼n Ã§eÅŸit Ã§eÅŸit ev yemeÄŸinin Ã§Ä±kÄ±yor olmasÄ± Ã§ok cazip, ister zeytinyaÄŸlÄ±lar ister sÄ±cak yemekler insanÄ± her gÃ¼n fast food yemekten alÄ±koyuyor.	FOOD#STYLE_OPTIONS
ZeytinyaÄŸlÄ± tabaÄŸÄ± baÅŸarÄ±lÄ±, salatalarÄ±nÄ±n da porsiyonu Ã§ok bÃ¼yÃ¼k tavsiye ederim.	FOOD#QUALITY FOOD#STYLE_OPTIONS
denÄ±z kenarÄ± gÄ±bÄ±dÄ±r ancak arada bÄ±r arsalÄ±k mesafe vardÄ±r.	
ve oradakÄ± koku olayÄ±na bÄ±r hal care bulamadÄ±klarÄ± Ä±cÄ±n yazÄ±k olan mekandÄ±r.	AMBIENCE#GENERAL
emÄ±rgandakÄ± sutÄ±sÄ± mumla aratmaktadÄ±r.	
Taksim'de kendi tarzÄ±na gÃ¶re keyifle gidilecek mekanlardan biri.	RESTAURANT#GENERAL
GÃ¼ndÃ¼z ayrÄ± gece ayrÄ± olarak deÄŸerlendirebilirim.	
Hizmet kalitesi daha Ã¶nce Avrupa'da gittiÄŸim ÅŸubelere gÃ¶re burada daha iyi diyebilirim.	
Bu yÃ¼zden tip bÄ±rakmayÄ± unutmayÄ±n :	
) Hamburgeri hoÅŸuma gidiyor ve NY steak de tavsiye edebilirim.	FOOD#QUALITY FOOD#QUALITY
Ä°Ã§ecek olarak genelde bira sevdiÄŸim iÃ§in kokteylleri iÃ§in bir ÅŸey sÃ¶yleyemeyeceÄŸim.	DRINKS#QUALITY
Afiyetle!	FOOD#QUALITY
Ben artÄ±k happy moons u beÄŸenmiyorum.	RESTAURANT#GENERAL
Servisi iyiydi Ã§alÄ±ÅŸanlarÄ± gÃ¼leryÃ¼zlÃ¼ fakat yemeklerinden eskiden aldÄ±ÄŸÄ±m tadÄ± almÄ±yorum.	SERVICE#GENERAL SERVICE#GENERAL FOOD#QUALITY
Ben bi tek Ã§ilekli limonatasÄ±nÄ± beÄŸendim, Ã§ok tavsiye etmem	RESTAURANT#GENERAL DRINKS#QUALITY
Ã–yle bir manzara ve konum iÃ§in olabilecek son mekan filizler olmalÄ±ydÄ±.	RESTAURANT#GENERAL AMBIENCE#GENERAL
Zaman kaybÄ±!	RESTAURANT#GENERAL
Yemekleri fena degil.	FOOD#QUALITY
Ozellikle zeytinyaglilari guzel.	FOOD#QUALITY
Galata cevresinde zeytinyagli veya ev yemegivari yiyebilecegimiz nadir yerlerden oldugu icin tercih ediyorduk.	FOOD#QUALITY
Ama dunyanin en yavas evlere servis hizmetini sunuyorlar.	SERVICE#GENERAL
Hele de ogle saatinde 50 ile 70 dakika beklemeye hazir olun.	SERVICE#GENERAL
Ogle saatleri degilse de 25-30 dk beklemeyi goze almak gerekiyor.	SERVICE#GENERAL
En son soyledigimiz firinda makarnasi da kuru geldikten sonra bir daha siparis vermemeye karar verdik.	FOOD#QUALITY
Manzarasi Ã§ok gÃ¼zel , dekorasyonda Ã§ok baÅŸarÄ±lÄ±ydÄ± , kahvaltÄ± iÃ§in gittik kahvaltÄ± gÃ¼zeldi ama omleti beÄŸenmedim Ã§ok tatsÄ±zdÄ±.	FOOD#QUALITY FOOD#QUALITY AMBIENCE#GENERAL AMBIENCE#GENERAL
Geri kalan hersey tazeydi kayÄ±sÄ± ve cevizle sÃ¼slemeleri Ã§ok hoÅŸuma gitti kahvaltÄ±ya fresh bir hava katmÄ±ÅŸlar.	SERVICE#GENERAL SERVICE#GENERAL
KahvaltÄ±sÄ± iÃ§in gidebilir ama garsonlar servis ederken gÃ¶rdÃ¼ÄŸÃ¼m kadarÄ±yla yemek porsiyonlarÄ± kÃ¼Ã§Ã¼ktÃ¼ ve sunum hoÅŸuma gitmedi .	FOOD#STYLE_OPTIONS FOOD#STYLE_OPTIONS FOOD#QUALITY
KÄ±sacasÄ± manzarasÄ± iÃ§in gidilebilinir bir yer sadece .	RESTAURANT#GENERAL AMBIENCE#GENERAL
Ä°lk Evlilik yÄ±ldÃ¶nÃ¼mÃ¼ yemeÄŸimizi burada yemiÅŸtik, karÅŸÄ±lama gayet gÃ¼zel kibar Ã§alÄ±ÅŸanlar.	SERVICE#GENERAL SERVICE#GENERAL
Sunumu beÄŸendik.	SERVICE#GENERAL
Sakin mutlu bir yemekti.	AMBIENCE#GENERAL
Tekrar gitmeyi dÃ¼ÅŸÃ¼nÃ¼rÃ¼m.	RESTAURANT#GENERAL
Klasik rakÄ±-balÄ±k-fasÄ±l Ã¼Ã§lemesinden sÄ±kÄ±lan, ve mezelere odaklanmak isteyenler iÃ§in en iyi alternatif.	FOOD#QUALITY
Manzara olarak en iyi seÃ§eneÄŸi sunmasa da lakerdasÄ± baÅŸta olmak Ã¼zere bÃ¼tÃ¼n mezeleri denemeye deÄŸer.	AMBIENCE#GENERAL FOOD#QUALITY FOOD#QUALITY
FÄ±stÄ±klÄ± peynirli meze, buraya Ã¶zel bir lezzet.	FOOD#QUALITY
KiÅŸi baÅŸÄ± 60 liraya rakÄ±nÄ±z ve mezelerinizle gÃ¼zel bir akÅŸam geÃ§irmeniz garanti.	RESTAURANT#PRICES FOOD#QUALITY
Konum itibariyle cok guzel yerde, manzarasi enfes.	AMBIENCE#GENERAL LOCATION#GENERAL
Limonatasi kocaman ve lezzetliydi, "ayvalik tostu"nu yeniden yorumlayarak tamamen farkli bir hale getirmisler, fena degildi.	DRINKS#STYLE_OPTIONS DRINKS#QUALITY FOOD#QUALITY
Ancak mekanin en buyuk sÄ±kÄ±ntÄ±sÄ± hizmet kalitesi, cok cok yavaslar!	SERVICE#GENERAL
Ki bana gore bir mekanda olmasi gereken en onemli ozellik "hizmet kalitesi" En buyuk kurtaricisi lokasyon ve muhtesem bogaz manzarasi!	AMBIENCE#GENERAL SERVICE#GENERAL LOCATION#GENERAL
Sinirsz kahvalti keyfi iÃ§in harika bir yer.	FOOD#QUALITY
Manzarasi cok gÃ¼zel.	AMBIENCE#GENERAL
Garsonlar biraz daha gÃ¼ler yÃ¼xlÃ¼ olabilir.	SERVICE#GENERAL
40 tl kisi basi.	RESTAURANT#PRICES
Zengin bir acik bÃ¼fe menÃ¼sÃ¼ var.	FOOD#STYLE_OPTIONS
Keyifli bir yer.	RESTAURANT#GENERAL
Son zamanlarÄ±n benim iÃ§in en bÃ¼yÃ¼k hayal kÄ±rÄ±klÄ±ÄŸÄ±.	RESTAURANT#GENERAL
Bu kadar bÃ¼yÃ¼k merakla gelip de yediklerimden bu kadar az haz ettiÄŸim baÅŸka bir yer olmadÄ±.	FOOD#QUALITY
Garson arkadaÅŸlar, mekanÄ±n manzarasÄ±, hizmet ÅŸahane ama lezzet adÄ±na sÃ¶yleyebileceÄŸim Ã§ok ÅŸey yok.	AMBIENCE#GENERAL FOOD#QUALITY SERVICE#GENERAL SERVICE#GENERAL
KÃ¶prÃ¼ altÄ± yerleri gibi kalamar koydular Ã¶nÃ¼mÃ¼ze.	FOOD#QUALITY
Bunu yazarken henÃ¼z hesap gelmemiÅŸti ve deÄŸerlendirmemi tamamen baÄŸÄ±msÄ±z ÅŸekilde yapÄ±yorum.	
YeÅŸilkÃ¶y efsanesi burada sÃ¼rmemiÅŸ	RESTAURANT#GENERAL
YÄ±llar Ã¶nce keyifli mekan sayÄ±sÄ± azken sÄ±klÄ±kla tercih ettiÄŸimiz, mekan sayÄ±sÄ± arttÄ±kÃ§a da geri plana ittiÄŸimiz mekanlardan.	RESTAURANT#GENERAL
BahÃ§esi insana huzur veriyordu...	AMBIENCE#GENERAL
Manzara guzel servis rezalet , 3 kere soylemeden getirmiyorlar , iki kere degil 5 kere dusunun gelirken	AMBIENCE#GENERAL SERVICE#GENERAL
Bir yanÄ± benzinlik bir yanÄ± mezarlÄ±k manzaralÄ± ama Ã§okta tutan bir cafe.	AMBIENCE#GENERAL RESTAURANT#GENERAL
E5 Ã¼stÃ¼nde olduÄŸu iÃ§in Ã§abuk direksiyon kÄ±rÄ±lÄ±p az vakitte Ã§ok oturmalÄ±k kolaylÄ±ÄŸÄ± iÃ§in tercih ettik.	LOCATION#GENERAL
BahÃ§esi keyifli yemekte Ã§ok kÃ¶tÃ¼ deÄŸildi.	AMBIENCE#GENERAL FOOD#QUALITY
ArkasÄ±ndan iÃ§tiÄŸimiz kahve iÃ§in Ã§ok beklesekte fazla beklentisiz bir cafe olduÄŸundan notu 3.5 olarak verdim	SERVICE#GENERAL RESTAURANT#GENERAL
Acik kasarli pide.	
besiktas barbarosta bulunan sampi sabaha kadar acik,gece cani cekenler icin ideal ve paket servisi de var,kapali kasarlisi da cok lezzetli oluyor	FOOD#QUALITY
Pizzalarini fena bulmadim.	FOOD#QUALITY
Acikcasi cok ayilip bayilani var ama ben daha kalin hamurlu pizzalari seviyorum.	FOOD#STYLE_OPTIONS
Ama Pizzeria Trio' nun pizzalari da guzel.	FOOD#QUALITY
Ben Trio Speciale yi tercih ettim.	
Eti kotuydu net ama geri kalan urunleri fena sayilmazdi.	FOOD#QUALITY FOOD#QUALITY
Ä°nanilmaz bir manzaraya sahip bu arada mekan.	AMBIENCE#GENERAL
Pizza, sarap, manzara kombini icin gidilebilir.	DRINKS#QUALITY AMBIENCE#GENERAL FOOD#QUALITY
Ã–zellikle bahÃ§esini tercih edin giderseniz.	AMBIENCE#GENERAL
aÃ§Ä±k alan gayet rahat.	AMBIENCE#GENERAL
gÃ¼rÃ¼ldÃ¼ de daha az.	
iÃ§ecekler gÃ¼zel, ama fastfood tarzÄ± atÄ±ÅŸtÄ±rmalÄ±k tercih edecekseniz pek tavsiye etmem.	DRINKS#QUALITY FOOD#QUALITY
Yemekler fena deÄŸil fakat porsiyonlar Ã§ok ufak.	FOOD#QUALITY FOOD#STYLE_OPTIONS
rejim yapanlar dÃ¼ÅŸÃ¼nÃ¼lmÃ¼ÅŸ sanÄ±rÄ±m.	
Fiyat biraz fazla gibi.	RESTAURANT#PRICES
Burasi eskiden favori yerlerimdendi menÃ¼sÃ¼ degisti ve artik eski menudeki yemeklerin bile tadi ayni degil lezzet olarak cok kÃ¶tÃ¼.	FOOD#QUALITY
Lezzet disinda degerlendirirsek hem dis alani bahcesiyle hemde ic alani rahat buyuk koltuklariyla cok keyifli bir mekan	AMBIENCE#GENERAL AMBIENCE#GENERAL AMBIENCE#GENERAL
Denize yakÄ±n yer bulursanÄ±z ÅŸanslÄ±sÄ±nÄ±z ...	
TadÄ± bir baÅŸka aÅŸÅŸkÄ±n kuruÃ§eÅŸmenin en iyi mekanÄ± diyebiliriz arkadaÅŸlarla kahve iÃ§ip sohbet etmek burda bir baÅŸka	RESTAURANT#GENERAL
KadÄ±kÃ¶y'Ã¼n bira cennetlerinden biri.	DRINKS#STYLE_OPTIONS
Eski Ã§alÄ±ÅŸanlarÄ± daha iyi ve samimiydi diye dÃ¼ÅŸÃ¼nÃ¼yorum.	SERVICE#GENERAL
Mevcut Ã§alÄ±ÅŸanlarÄ±nÄ±n marjinal gÃ¶rÃ¼nÃ¼mlerini yadÄ±rgamamakla birlikte , bu marjinal gÃ¶rÃ¼ntÃ¼ hafiften cool davranÄ±ÅŸlara kaÃ§Ä±yor, bu da hizmete olumsuz yansÄ±yor.	SERVICE#GENERAL
Daha gÃ¼lÃ¼mseyen bir Ã§alÄ±ÅŸan profili olmalÄ±.	SERVICE#GENERAL
Hizmeti ortalama, yemekler ortalama.	FOOD#QUALITY SERVICE#GENERAL
Yine de bol Ã§eÅŸit bira denemek ve mÃ¼zik dinlemek iÃ§in gidilmeli.	AMBIENCE#GENERAL DRINKS#STYLE_OPTIONS
Yemekler Ã§ok vasat.	FOOD#QUALITY
her zaman Ã§ok yoÄŸun.	SERVICE#GENERAL
iÃ§erde mÃ¼zikten birbirini duyamÄ±yorsun.	AMBIENCE#GENERAL
servis elemanlarÄ± kaba.	SERVICE#GENERAL
sadece fiyatlar makul.	RESTAURANT#PRICES
menÃ¼ kÄ±sÄ±tlÄ±	FOOD#STYLE_OPTIONS
Cizbiz koftesi , sutis moccachinosu , dtox corbasi ve haftasonu hahvalti zenginligiyle tavsiye edebilecegim bir Mekan manzarasi , ulasim rahatligi konforuyle denemenizi tavsiye Ederim	LOCATION#GENERAL FOOD#STYLE_OPTIONS FOOD#QUALITY FOOD#QUALITY AMBIENCE#GENERAL DRINKS#QUALITY
Sosyal medyada Ã¼nlÃ¼ olduktan sonra kaliteyi dÃ¼ÅŸÃ¼rmÃ¼ÅŸ mekanlardan bir tanesi.	RESTAURANT#GENERAL
ManzarasÄ± muhteÅŸem,servis orta ama yemekler Ã¼zgÃ¼nÃ¼m kÃ¶tÃ¼.	
ArkadaÅŸÄ±m aÅŸkÄ± memnu sÃ¶yledi,ben de cheescake sÃ¶yledim.	FOOD#QUALITY FOOD#QUALITY
Ä°kisi de durmuÅŸ ve kÃ¶tÃ¼ kalite malzeme kullanÄ±lmÄ±ÅŸtÄ±.	FOOD#QUALITY
En azÄ±ndan adlarÄ±yla Ã¶zdeÅŸleÅŸmiÅŸ tatlÄ±larÄ±na Ã¶zen gÃ¶stermelerini beklerdim.	FOOD#QUALITY
Bu manzarada ne versek yerler mantÄ±ÄŸÄ±nda bir iÅŸletmenin KuruÃ§eÅŸme'de olmasÄ±na Ã§ok Ã¼zÃ¼ldÃ¼m.	RESTAURANT#GENERAL
Ã–nermiyorum, eminim aynÄ± gÃ¼zellikte manzaraya sahip ama yemekleri mÃ¼ÅŸteriye saygÄ± gereÄŸi taze ve iyi malzemeyle yapÄ±lmÄ±ÅŸ bir yer bulabilirsiniz civarda.	AMBIENCE#GENERAL FOOD#QUALITY
anzarasi harika...	AMBIENCE#GENERAL
- Burasi haftada bir ugramaya Ã§alistigim ve manzarasina bayildigim bir mekan.	AMBIENCE#GENERAL
Ancak bir seyler yemek iÃ§in Ã§ok iyi denemez.	FOOD#QUALITY
Pastalari 3. sinif pastane mamulleri gibi...	FOOD#QUALITY
Ayrica genelde Ã§ok kalabalik olmasi nedeniyle yer kapmak iÃ§in bayagi bir ugrasmak gerekiyor.	SERVICE#GENERAL
Servis vasat.	SERVICE#GENERAL
Ã‡atal, bÄ±Ã§ak pis ve cevizli baklavasÄ± ÅŸerbetinden insanÄ±n midesini bulandiriyor.	SERVICE#GENERAL FOOD#QUALITY
AyrÄ±ca baklava yanmÄ±ÅŸ gibi.	FOOD#QUALITY
FÄ±stÄ±klÄ± tatlÄ±lar idare eder.	FOOD#QUALITY
UÄŸramaya gerek yok Ã§ok daha iyi yerler var.	
Karakoyde yer alan sirin bir cafe.	RESTAURANT#GENERAL
3 kisi icin idealdi.	
SÄ±k sÄ±k gelip butun caylardan denemek lazim.	DRINKS#QUALITY
Fiyatlar yuksek ama verdiginiz paraya degiyo	RESTAURANT#GENERAL RESTAURANT#PRICES
Dekorasyonu cok hos.	AMBIENCE#GENERAL
Cok rahat koltuklari var.	AMBIENCE#GENERAL
Oturup saatlerce kaliteli cay esliginde muhabbet edebilirsiniz.	DRINKS#QUALITY AMBIENCE#GENERAL
Arkadasim ozel demlikte cin cayi soyledi ben de ev yapimi seftalili buzlu cay.	
Buzlu cay hayatimda ictigim en iyi buzlu caydi.	DRINKS#QUALITY
Seker orani yerindeydi ve cok ferahlatiyordu.	DRINKS#QUALITY
Cin cayi nin tadi da cok guzeldi.	DRINKS#QUALITY
Kavun aromasinin kivami yerindeydi ama ic ic bitmedi bir turlu.	DRINKS#QUALITY
Fiyat/Performans olarak gidilebilecek mekanlardan birisi Uzunlar Kebap.	RESTAURANT#GENERAL RESTAURANT#PRICES
Piyasada bulunan kebapÃ§Ä±lara gÃ¶re 1 tÄ±k daha iyidir.	RESTAURANT#GENERAL
Haftasonu gezmeleri iÃ§in de gidilebilir, aÃ§ kaldÄ±ÄŸÄ±nÄ±zda yemeÄŸimi yiyip hemen kalkayÄ±m mantÄ±ÄŸÄ±nda da gidebilirsiniz.	RESTAURANT#GENERAL
Berbat bir yer,insanlarin sefil oldugu,gÃ¶cmen burosuna sÄ±ra bekleyen biri gibi hissettim,rezalet...	RESTAURANT#GENERAL SERVICE#GENERAL
asla gitmeyin.	RESTAURANT#GENERAL
paranÄ±zla rezil olmak isterseniz buyrun derim.	RESTAURANT#GENERAL
Bir goz baslayan ekonomik hayatina neredeyse tum sokaga yerleserek devam eden bir isletme.	
Menusundeki hemen hemen hersey oldukca lezzetli.	FOOD#QUALITY
Ozellikle acik bufe sabah kahvaltisi evinizde yapiyormus gibi keyifli.	FOOD#QUALITY
Ogle yemeklerinde mutlaka erken orda olmak gerek, yoksa yiyeceknyemek bulmakta zorlanabilirsiniz.	
Standart bir kahvalti fakat ortam,servis,mekanin konumu Ã§itayi yÃ¼kseltiyor.	AMBIENCE#GENERAL SERVICE#GENERAL FOOD#QUALITY AMBIENCE#GENERAL
Ã–zellikle servis elemani Sezgin bey 'in isini bu kadar iyi yapmasi ve herkesle esit ayni gÃ¼ler yÃ¼zle ilgilenmesi , masalar arasi slalom yaparken hiÃ§ bir istegi ikiletmemesi hepimizin sempatisini ve takdirini kazandi.	SERVICE#GENERAL SERVICE#GENERAL
GÃ¶ksu'da gidilebilecek en hos cafelerden biri bence.	RESTAURANT#GENERAL
GeniÅŸ bahÃ§esi ve terasÄ± ile bu lokasyona yakÄ±n arkadaÅŸlarÄ±n yaz akÅŸamlaÄ±nda aÃ§Ä±k haavada nargile keyfi yapabilecekleri bir mekan.	AMBIENCE#GENERAL AMBIENCE#GENERAL
Ã§Ä±kÄ±ÅŸta dÃ¼rÃ¼m tÄ±r da dÃ¼rÃ¼mlerinizi yiyebilirsiniz ?	
Ulasim oldukca kolay.	LOCATION#GENERAL
Otoparki vale sistemiyle calisiyor.	LOCATION#GENERAL
Cevre duzenlemesi okadar guzel yapilmiski daha yemekleri tatmadan iyi geldim diyorsunuz.	AMBIENCE#GENERAL
Etler , meze, salata ve patates kizartmasi da size kesinlikle aksini dusundurmuyor.	FOOD#QUALITY FOOD#QUALITY
Hepsi ayri lezzetli.	FOOD#QUALITY
Acildigindan beri ara sira gidiyordum.	RESTAURANT#GENERAL
Ickiyi yasakladiklari icin (kendi tabirleriyle %15 musteriden biri old.	
icin) artik gitmiyorum.	RESTAURANT#GENERAL
Yasaklatanlara hayirli olsun!	RESTAURANT#GENERAL
Vasat - Istanbul'daki kebapÃ§ilarla kiyaslayacak olursak gerÃ§ekten vasat.	FOOD#QUALITY
Ama benim derdim kebap degil yeni bir yer gÃ¶rmek diyorsaniz kesinlikle tavsiye edilir.	AMBIENCE#GENERAL FOOD#QUALITY
Ancak Ã§ok bÃ¼yÃ¼k beklentiyle gidilmemeli ki sonra Ã§ok Ã¼zÃ¼lmemeli:	RESTAURANT#GENERAL
Ozel gun yemeklerinizi yiyebileceginiz luks bir restorant.	RESTAURANT#GENERAL
Kulbasti ve ozellikle ev yapimi sufleyi tavsiye ediyorum.	FOOD#QUALITY FOOD#QUALITY
Rezervasyon sirasinda ozel gununuzu soylediginiz takdirde sampanya ikramlari oluyor bu guzel bir jest	SERVICE#GENERAL DRINKS#STYLE_OPTIONS
Yemek servisi ve lezzeti iyi bir restaurant.	SERVICE#GENERAL FOOD#QUALITY
Servis SÃ¼releri biraz uzun birde bulunduÄŸu mekana ve mekanÄ±n fiziksel kalitesine gÃ¶re fiyatlar pahalÄ±.	SERVICE#GENERAL RESTAURANT#PRICES
Daha mÃ¼tevazÄ± menu fiyatlarÄ± olsa daha sÄ±k ziyaret edilebilir	RESTAURANT#PRICES
Ã‡ikolatalÄ± baklavasÄ±na bayÄ±lÄ±yorum kesinlikle en favori tatlÄ±m.	FOOD#QUALITY
DiÄŸer bÃ¼tÃ¼n tatlÄ±larÄ±nÄ±n kalitesi ve lezzeti Ã¼st seviyede.	FOOD#QUALITY
GÃ¼llÃ¼oÄŸlu bu konuda uzman.	RESTAURANT#GENERAL
Nusret etin prensi diyorsak bildiÄŸimiz var ki diyoruz.	FOOD#QUALITY
ğŸ˜ Etleri muhteÅŸem lezzetliydi.	FOOD#QUALITY
Evde de aynÄ±sÄ±nÄ± bir aÅŸÃ§Ä± adayÄ± olarak yapsam bile Nusret'inki farklÄ±.	FOOD#QUALITY
Kaliteli yemek sevenler mutlaka gitsin denesin.	FOOD#QUALITY
Jumbo combo ve kola istedim ama bÃ¶rek ve tavuk parÃ§alarÄ± dÄ±ÅŸÄ±ndaki tatlar bana gÃ¶re deÄŸildi.	FOOD#QUALITY FOOD#QUALITY
SoslarÄ± sevmedim ve soÄŸan halkalarÄ±nÄ±n tadÄ± tatlÄ± geldi.	FOOD#QUALITY FOOD#QUALITY
Nachos istemediÄŸime piÅŸman oldum.	FOOD#QUALITY
Cumartesi olmasÄ±na raÄŸmen sakindi.	AMBIENCE#GENERAL
Telefonun ÅŸebekesi Ã§ekmediÄŸi iÃ§in wifi ye baÄŸlanmak istedim ama oturduÄŸum mÃ¼ddetÃ§e baÅŸarÄ±lÄ± olmadÄ±m.	SERVICE#GENERAL
Servis hÄ±zlÄ± ve Ã§alÄ±ÅŸanlarÄ± pozitifti.	SERVICE#GENERAL SERVICE#GENERAL
GÃ¼zel bir cafe ama maalesef hard rock deÄŸil.	AMBIENCE#GENERAL RESTAURANT#GENERAL
aÃ§Ä±kÃ§asÄ± Ã§okta tavsiye edilecek bir yer deÄŸil bence , press ile yanyana olunca bir orayada bakayim dedim fakat oturmamla kalkmam bir oldu .	RESTAURANT#GENERAL
Sadece TÃ¼rk kahvesi var ve bir sÃ¼rÃ¼ Ã§ay Ã§eÅŸidi tadlari belki gÃ¼zeldir ama hem pahali hem gereksiz bir yer bence	RESTAURANT#GENERAL RESTAURANT#PRICES
Birde burdaki yerini deniyeyim dedim geÃ§enlerde ama tam bir hayal kirikligi garsonlar asiri ilgisiz kebaplar diger subelerine gÃ¶re basarisiz cok sarimsakli ve rahatsiz edici manzara gibi bir olayi yok bridge 'in tam tersi tarafinda kaldigi icin evlere bakiyor bos bos gitmeye degecek bir yer degil lezzette kÃ¶tÃ¼ zaten ilk ve son gidisim olacak fakat servis iÃ§in gÃ¶ztepe subesi gerÃ§ekten gÃ¼zel salatalari bile paket sekilde gonderiyor .	AMBIENCE#GENERAL FOOD#QUALITY FOOD#QUALITY RESTAURANT#GENERAL SERVICE#GENERAL SERVICE#GENERAL
Dostlarinizla birlikte gÃ¼rÃ¼ltÃ¼den uzak, bir seyler iÃ§me dÃ¼sÃ¼ncesindeyseniz birbirinizin sesini rahatlikla duyabileceginiz mÃ¼kemmel bir yer Limonlu BahÃ§e.	AMBIENCE#GENERAL
BahÃ§esindeki kedilerinin birbirini kovalamasi ise mutluluktan midenizde kelebekler uÃ§urtuyor!	AMBIENCE#GENERAL
Tek sorun siparisin Ã§ok geÃ§ gelmesi ve yemeklerin performans-fiyat birlikteliginin tutarli olmamasi	FOOD#PRICES SERVICE#GENERAL
PopÃ¼lerliÄŸin etkisiyle kaliteyi dÃ¼ÅŸÃ¼ren, malzemeyi azaltan bir yer oldu.	RESTAURANT#GENERAL FOOD#STYLE_OPTIONS
Baklavada fÄ±stÄ±ÄŸÄ± ara ki bulasÄ±n.	FOOD#STYLE_OPTIONS
Paket alÄ±nan baklavalarÄ±n bayat olma ihtimali yÃ¼ksek, dikkatli olun.	FOOD#QUALITY
Su bÃ¶reÄŸi de kÃ¶tÃ¼.	FOOD#QUALITY
Zaten o kalabalÄ±kta oturmaya o gÃ¼rÃ¼ltÃ¼yÃ¼ Ã§ekmeye bile deÄŸmez.	AMBIENCE#GENERAL
Normal mekan normal tatlar.	FOOD#QUALITY AMBIENCE#GENERAL
Ã–vgÃ¼ Ã¼zerine gitmiÅŸtik ama fazla beklentiye girince bazen normal bulacaÄŸÄ±nÄ±z ÅŸeyi de bepenmeyebiliyorsunuz.	RESTAURANT#GENERAL
Bence istanbulda iyi denilen mekanlarda bile meze probleni var.	FOOD#QUALITY
SÄ±radan lezzetler.	FOOD#QUALITY
Burda da aynÄ± durum geÃ§erli iÅŸte	RESTAURANT#GENERAL
Her zaman keyifli - Her zaman keyifle gittigim mekanlardan biri olmustur.	RESTAURANT#GENERAL
BahÃ§esi Ã§ok gÃ¼zel.	AMBIENCE#GENERAL
Misafirlerini Ã§ok gÃ¼zel host ediyorlar.	SERVICE#GENERAL
Canyon Road ve Big Burger her zaman favorimdir.	FOOD#QUALITY FOOD#QUALITY
Pardon biraz once yazmistim.	
Tekrar yazayim dedim.	
Biri lutfen arka masada oturan bayanlari ikaz etsin:	
cok yuksek sesle gulup egleniyorlar.	AMBIENCE#GENERAL
Ugramadan geÃ§meyin - Konum olarak gÃ¼zel bir yere kurulan ve disaridan geÃ§erken gÃ¶rsel olarak iÃ§eri Ã§agiran ayrica iÃ§eri girildiginde de pisman etmeyen bir mekan.	AMBIENCE#GENERAL LOCATION#GENERAL
Burasi oldukÃ§a lezzetli yemekler yapiyor ve sunum, hijyen, herkes Ã§ok sicak kesinlikle gidilmeli.	FOOD#QUALITY SERVICE#GENERAL
GÃ¼zel manzara, yetersiz menÃ¼ - Otagtepe'nin manzarasi Ã§ok gÃ¼zel ancak ne yazik ki bu manzaraya uyacak bir menÃ¼ zenginligi, yemek kalitesi yok.	AMBIENCE#GENERAL AMBIENCE#GENERAL FOOD#QUALITY FOOD#STYLE_OPTIONS
Hizmet kalitesi de iyi degil.	SERVICE#GENERAL
Deniz mahsullÃ¼ pizzasÄ± gÃ¼zel deÄŸil.	FOOD#QUALITY
Riske girmeden hamburger, wrap, sandviÃ§ tarzÄ± bir ÅŸey sÃ¶ylemek en mantÄ±klÄ±sÄ±.	AMBIENCE#GENERAL
AyrÄ±ca rezervasyon alÄ±yorlar ki Numnum'sÄ±nÄ±z siz havanÄ±z kime diyesi geliyor insanÄ±n.	SERVICE#GENERAL
Pek Ã§ok kiÅŸiden duyunca merak edip Ã¶ÄŸlene doÄŸru gittik mekana,denilenin aksine boÅŸtu ama sonrasÄ±nda epey doldu.	
FÄ±rÄ±nda makarnasÄ±nÄ± denedim ama Ã§ok beÄŸendiÄŸimi sÃ¶yleyemeyeceÄŸim.	FOOD#QUALITY
ZeytinyaÄŸlÄ±larÄ± deneyince tam fikrimi belireteceÄŸim.	
3 aydir haftasonlari ugrak noktamizdi, Kahvehane gibi maÃ§ Ã¼creti 10 tl diye yazdilar yaa o gun bizim gozumuzde bitti.	RESTAURANT#PRICES
Gidicekler simdiden dikkatli olsun.	RESTAURANT#GENERAL
Mudavimi oldugum diger mekanim, ascisi super yemekler cikariyor isletmecisini cok seviyoruz , balli tavuk salata , yesil mercimek corbasi, kestanesi suflesi ve birbirinden saglikli fresh meyve sulari deneyin derim ,bogazin gobeginde yemeginizi yemenin keyfine varin	RESTAURANT#GENERAL FOOD#QUALITY FOOD#QUALITY FOOD#QUALITY DRINKS#QUALITY AMBIENCE#GENERAL SERVICE#GENERAL
FethipaÅŸa korusunun iÃ§inde bulunan manzarasÄ±na gÃ¶re uygun fiyata sahip salaÅŸ ÅŸÄ±k aileye uygun bir mekan.	RESTAURANT#PRICES LOCATION#GENERAL AMBIENCE#GENERAL
Ã¶zellikle yaz akÅŸamlarÄ± terasÄ±nda semaver Ã§ayÄ±nÄ± denemelisiniz	DRINKS#QUALITY
yaz aylarÄ± iÃ§in bahÃ§esi beÅŸiktaÅŸ'taki en ferah yer olabilir.	AMBIENCE#GENERAL
yemekleri lezzetli, servis hÄ±zlÄ± ve Ã§alÄ±ÅŸanlar gÃ¼ler yÃ¼zlÃ¼.	FOOD#QUALITY SERVICE#GENERAL SERVICE#GENERAL
iÃ§ dekorasyonu da gayet hoÅŸ.	AMBIENCE#GENERAL
mÃ¼zikler de ortam ile uyumlu.	AMBIENCE#GENERAL
Malesef ki sadece pazar gÃ¼nÃ¼ brunch veren bir yer.	FOOD#STYLE_OPTIONS
KahvaltÄ±sÄ±nÄ± denemediyseniz denemelisiniz Ã§ok fazla Ã§eÅŸit var hatta hangisini yesek diye ÅŸaÅŸÄ±rÄ±yorsunuz.	FOOD#STYLE_OPTIONS
Saatlerce pazar keyfi yapabilceÄŸimiz bir yer.	RESTAURANT#GENERAL
ManzarasÄ±na zaten diyecek tek bir kelime yok.	AMBIENCE#GENERAL
BÃ¶yle bir yerin tabi ki fiyatlarÄ± PahalÄ±.	RESTAURANT#PRICES
Garsonlar ilgili, yemekler gÃ¼zel	FOOD#QUALITY SERVICE#GENERAL
TuzlanÄ±n meÅŸhur balÄ±kÃ§Ä±sÄ±.	RESTAURANT#GENERAL
Eskiye nazaran kalitesi oldukÃ§a dÃ¼ÅŸÃ¼k.	RESTAURANT#GENERAL
Eskiden mekan daha ufak sÄ±nÄ±rlÄ± sayÄ±da mÃ¼ÅŸteriye hizmet eden ama kalitesini bozmayan bir yerdi.	RESTAURANT#GENERAL
Maalesef son 1 senede kalitesinde ve serviste epey sÄ±kÄ±ntÄ±lÄ±.	SERVICE#GENERAL RESTAURANT#GENERAL
Tatlilari da denenmeli bence.	FOOD#QUALITY
Manzarasi da ayrica gÃ¼zeldir.	AMBIENCE#GENERAL
Plaza insanÄ± iÃ§in Ã¶ÄŸle yemeklerinde bir alternatif kanÄ±mca.	RESTAURANT#GENERAL
DeÄŸiÅŸiklik aradÄ±ÄŸÄ±mÄ±zda gidip pek de deÄŸilik bir ÅŸey yeniyoruz aslÄ±nda.	
Ev yemeklerini hakettiÄŸinden pahalÄ±ya sattÄ±klarÄ±nÄ± dÃ¼ÅŸÃ¼nÃ¼yorum.	FOOD#PRICES
GÃ¶ksunun kenarÄ±nda Ã§ok ÅŸirin bir yer.	AMBIENCE#GENERAL
Yemekleri de gayet lezzetliydi.	FOOD#QUALITY
GÃ¶rselliÄŸe pek Ã¶nem vermedikleri aÅŸikar yine de.	AMBIENCE#GENERAL
Ama hizmet konusunda on puan veriyorum	SERVICE#GENERAL
Uzun zamandan sonra yediÄŸim en gÃ¼zel kofte idi.	FOOD#QUALITY
hamburgerde Ã§ok gÃ¼zeldi.	FOOD#QUALITY
roka salatasÄ± GÃ¼veÃ§te mantarda baÅŸarÄ±lÄ± idi.	FOOD#QUALITY FOOD#QUALITY
biz kahvaltÄ±sÄ±nda denemek Ã¼zere tekrar geliriz	RESTAURANT#GENERAL
Ä°stanbul'da daha fazla olmasÄ± istenen mekanlardan.	RESTAURANT#GENERAL
DizaynÄ± gÃ¼zel.	AMBIENCE#GENERAL
KalabalÄ±k olduÄŸunda bile Ã§evrenizdeki masalarla iÃ§ iÃ§e hissettirmeyecek kadar ferah.	AMBIENCE#GENERAL
Ã–zellikle BoÄŸaziÃ§i Ãœniversitesi Ã¶ÄŸrencilerinin sÄ±kÃ§a uÄŸramasÄ± gereken bir mekan.	RESTAURANT#GENERAL
Yemek menÃ¼sÃ¼ geliÅŸtirilebilir.	FOOD#STYLE_OPTIONS
Fiyatlar gayet uygun.	RESTAURANT#PRICES
Quattro Stagioni ve Orto'yu denedik ancak beklentilerimizin altÄ±nda kaldÄ±.	FOOD#QUALITY
PizzalarÄ±ndan ziyade tiramusu Ã§ok daha baÅŸarÄ±lÄ±.	FOOD#QUALITY FOOD#QUALITY
Bir de dÃ¼kkanÄ±n minyatÃ¼r haldeki maketi Ã§ok tatlÄ±.	AMBIENCE#GENERAL
Cok fazla kisiye servis yapildigi icin cok basarili bulmuyorum mezeler dunden kalma gibi etler cok guzel degil yanliz adana kebabi fena degil ama daha iyileri oldugu icin baska yerde denemede fayda var	AMBIENCE#GENERAL FOOD#QUALITY FOOD#QUALITY SERVICE#GENERAL
Orta...	RESTAURANT#GENERAL
- Ambiansi hos.	AMBIENCE#GENERAL
Yemekleri basarili bulmuyorum, burgerler lezzetsiz, fajita iÃ§in kullandiklari et uygun degil.	FOOD#QUALITY FOOD#QUALITY FOOD#QUALITY
Genelde Ã§ok kalabalik oldugu iÃ§in de servis kosturmaca iÃ§inde yapiliyor.	SERVICE#GENERAL
KadÄ±kÃ¶y'de yemek yenecek en iyi yerlerden birisi Happy Moon's.	FOOD#QUALITY
GÃ¼nÃ¼n her saatinde gelinebilir.	RESTAURANT#GENERAL
Servis hÄ±zlÄ± sayÄ±lÄ±r mekan dekorasyonu gerÃ§ekten gÃ¼zel.	SERVICE#GENERAL AMBIENCE#GENERAL
Manzara muhtesem ama servis icin ayni seyi soyleyemeyecegim.	SERVICE#GENERAL AMBIENCE#GENERAL
Peynirli omlet ve menemen lezzetliydi ama patates kizartmasi fazla yag cekmisti.	FOOD#QUALITY FOOD#QUALITY
Gelen kahveler de maalesef sogumustu.	DRINKS#QUALITY
Abartildigini dÃ¼sÃ¼nÃ¼yorum.	RESTAURANT#GENERAL
Getirilen patates kizartmasi iÃ§in kullanilan yag kaÃ§inci kere kullanilmissa Ã¼zerinde siyahlasmis yag kalintilari vardi ve patatesler birakin Ã§itir olmayi hamur gibiydi.	FOOD#QUALITY FOOD#STYLE_OPTIONS
Domates/salatalik sÃ¶gÃ¼s beklemekten pÃ¶rsÃ¼mÃ¼stÃ¼.	FOOD#QUALITY
Etrafta kaotik bir hareketlilik yasanmasi yediginizden keyif almanizi zorlastiriyor.	AMBIENCE#GENERAL
Ãœzerine ortalama bir dÃ¶ner olunca ben tekrar gidecegimi sanmam.	FOOD#QUALITY RESTAURANT#GENERAL
BayÄ±ldÄ±ÄŸÄ±m bir yer mekan Ã§ok hoÅŸ her mezeyi tatmak gerekli evet keÅŸke fiyatlar daha insani boyutta olsa muhteÅŸem olurdu ama ne yapayÄ±m o kadar keyif alÄ±yorum ki verdiÄŸimiz para can acÄ±tmÄ±yor sadece daha seyrek gitmemize sebep oluyor ortam yemekler ve mÃ¼zik herÅŸey harika	AMBIENCE#GENERAL FOOD#QUALITY FOOD#QUALITY RESTAURANT#GENERAL RESTAURANT#PRICES AMBIENCE#GENERAL
nadir gÃ¼llÃ¼oglunun yeri gÃ¼zel bakimli ve taze lezzet sunuyor sadece bana Ã§ok sekerli geliyor damak tadimdan kaynaklanabilir hepsini genelde denedim fistikli baklava gÃ¼zel	FOOD#QUALITY LOCATION#GENERAL FOOD#QUALITY FOOD#QUALITY
Ã‡engelkÃ¶y'Ã¼n salaÅŸ Ã‡Ä±naraltÄ± kahvaltÄ±sÄ± dÄ±ÅŸÄ±nda muhteÅŸem bir alternatif.	
MekanÄ±n iÃ§ine cidden emek harcandÄ±ÄŸÄ± her halinden belli.	AMBIENCE#GENERAL
Ne kadar yoÄŸun olursa olsun, servis hÄ±zlÄ± yenilen her ÅŸey Ã§ok lezzetli.	FOOD#QUALITY SERVICE#GENERAL
PastÄ±rmalÄ± yumurta konusunda hala gÃ¶nlÃ¼mÃ¼n tek sultanÄ±dÄ±r SÃ¼tiÅŸ.	FOOD#QUALITY
Hasan KolcuoÄŸlu Ã§ok pahalÄ± diyemem ama hesap yÃ¼ksek sayÄ±lÄ±r; ayrÄ±ca sÃ¶zde aÃ§Ä±k ama aslÄ±nda kapalÄ± alanÄ±nda sigara iÃ§iliyor.	AMBIENCE#GENERAL RESTAURANT#PRICES
Mezeler Ã§ok Ã§eÅŸitli ve lezzetli, metrelik kebabÄ± da gÃ¼zel, o da gayet lezzetli fakat mecburen fix menÃ¼ alÄ±nÄ±yor.	AMBIENCE#GENERAL FOOD#QUALITY FOOD#STYLE_OPTIONS FOOD#QUALITY
Para Ã¶deyip istediÄŸini yiyememek biraz gereksiz israfa sebep oluyor, bence deÄŸiÅŸmeli	FOOD#STYLE_OPTIONS
mantÄ±sÄ± ficcini zeytinyaÄŸlÄ± mezgiti ile cok guzel yer.	FOOD#QUALITY
ama meyhane kismina bir kere oturdugumuzda arkadaslarimizi bekliyorduk zorla 10 tane meze getirdiler eger meze istemiyorsak oturamayacagimizi soylediler.	SERVICE#GENERAL
terbiyesiz birkac garsonu dÄ±ÅŸÄ±nda guzel bir yerdi	SERVICE#GENERAL RESTAURANT#GENERAL
Anadolu Yakasi'nda kebap yenebilecek en iyi ve en nezih yerlerden birisi.	FOOD#QUALITY AMBIENCE#GENERAL
Yemekleri ve ozellikle ara sicaklari cok lezzetli.	FOOD#QUALITY FOOD#QUALITY
Servis cok hizli.	SERVICE#GENERAL
Calisanlar guleryuzlu.	SERVICE#GENERAL
Cerkez yemekleri sevenler icin guzel bir tercih .	FOOD#QUALITY
Ozellikle mantisini cok begenmistim, mezeleri vs lezzetliydi .	FOOD#QUALITY FOOD#QUALITY
Sadece son gittigimde calisanlarin muamelesinden hic hosnut kalmadim, bu konuda daha dikkatli olmalilar.	SERVICE#GENERAL
Mekan dekorasyonu Ã§ok baÅŸarÄ±lÄ±.	AMBIENCE#GENERAL
Mezeler oldukÃ§a gÃ¼zel ve Ã§eÅŸitli.	FOOD#QUALITY FOOD#STYLE_OPTIONS
Ancak balÄ±klara gelince bir durdum.	FOOD#QUALITY
BildiÄŸin Ã§iftlik balÄ±ÄŸÄ± geldi.	FOOD#QUALITY
Daha lezzetli bir ana yemek bekliyordum aÃ§Ä±kÃ§asÄ±.	FOOD#QUALITY
Fiyatlar ortalama meyhane fiyatlarÄ±nÄ±n Ã¼zerinde.	RESTAURANT#PRICES
Etler gÃ¼zel, eti az ama Ã¶z piÅŸiren nadir yerlerden:	FOOD#QUALITY
Penne siciliano yedim yerken guzeldi ama sonra yagindan butun gun midem yandi.	FOOD#QUALITY FOOD#QUALITY
Arkadasim begendili tavuk yedi o da ayni seyi yasadi.	FOOD#QUALITY
Servis, ilgi mukemmel yemekler midede rahatsizlik yaratabiliyor.	FOOD#QUALITY SERVICE#GENERAL
YediÄŸim en iyi sahanda yumurta.	FOOD#QUALITY
YumurtanÄ±n neyi gÃ¼zel demeyin.	FOOD#QUALITY
Ortam mÄ± yumurta mÄ± tereyaÄŸÄ± mÄ± bilmiyorum.	
KavurmalÄ± efsane, saÃ§ma demeyin yanÄ±nda bakÄ±r kapta ayranÄ± da iÃ§in.	DRINKS#QUALITY FOOD#QUALITY
Yemekleri standart , mudur tarzinda kapida bekleyen kisi soguk ve ters birisi...	FOOD#QUALITY SERVICE#GENERAL
Bize bakan garson yuksek ses ile siparis almasi ayri bir entresan...	SERVICE#GENERAL
Ayni tarz mekanlarda insan iliskileri fark yaratir.	
eskiden daha iyiydi.	RESTAURANT#GENERAL
simdi fabrikasyon .	
servis .	
ok yavas.	
fiyatlar asiri uÃ§mus.	RESTAURANT#PRICES
artik lezzete degil popÃ¼lerligine gidiliyor.	FOOD#QUALITY
nusretin yerinde olsam buna Ã¼zÃ¼lÃ¼rdÃ¼m.	
Konum olaral harika , lezzet olarak iyi ancak gerÃ§ekten servis her gidiÅŸimde aynÄ± kÃ¶tÃ¼lÃ¼kte hiÃ§ Ã¶dÃ¼n vermiyorlar bu konuda.	FOOD#QUALITY LOCATION#GENERAL SERVICE#GENERAL
Birinin bu sorunu Ã§Ã¶zmesi gerekir	RESTAURANT#GENERAL
SÄ±cak, samimi ve iÃ§ten kÃ¼tÃ¼k ev cafe ...	AMBIENCE#GENERAL
Serpme kahvaltÄ±larÄ±n vazgeÃ§ilmezi oldu bizim iÃ§in haftasonu buraya gelip keyifli vakit geÃ§irebilirsiniz.	FOOD#QUALITY
Paket olarak dÃ¶nerlerini aldÄ±m, Ã¶zenle paketlenmiÅŸti, uzun bir yolculuk yapmÄ±ÅŸ olmama raÄŸmen aÃ§tÄ±ÄŸÄ±mda hala sÄ±caklÄ±ÄŸÄ±nÄ± koruyordu.	SERVICE#GENERAL
Malzemeden kÄ±sÄ±lmamasÄ± ve etinin lezzeti beni Ã§ok memnun etti.	FOOD#STYLE_OPTIONS FOOD#QUALITY
Bir gun once ayni saatte oglen menusu getiren garson, bir gun sonra kustahca "dun insiyatif alip getirdim ama bundan sonra vermem olur biter" diyerek getirmedi.	SERVICE#GENERAL
Kesinlikle gitmeyin, muamele cok kotu.	SERVICE#GENERAL
Iftardan sonra Ã§ay veya kahve keyfi yapmak iÃ§in ideal bir yer.	DRINKS#QUALITY AMBIENCE#GENERAL
Hem bogazin huzuruyla kendinizi dinlendirebilir, arkadaslarla koyu bir sohbetle uzun saatlerce oturabilir ve canli mÃ¼zik esliginde keyfinize keyif katabilirsiniz.	AMBIENCE#GENERAL AMBIENCE#GENERAL
Fiyatlari gercekten pahali fakat kaliteli ve hos bir mekan ariyorsaniz kesinlikle tercih edilebilir.	RESTAURANT#PRICES RESTAURANT#GENERAL
Ozellikle begendilerine kattiklari damla sakizi o kadar hos bir aroma veriyor ki anlatamam.	FOOD#QUALITY
Baslangiclarinin bir cogunu denedik hepside enfes.	FOOD#QUALITY
Tatli olarak sufleyi tercih ettik ve ona da bayildik.	FOOD#QUALITY
Mukemmel.	RESTAURANT#GENERAL
Tek eksik olarak etin orta pisimisini istememize ragmen cok pismis bir et ile karsilastik.	FOOD#STYLE_OPTIONS
YÄ±llardÄ±r dizaynini aynen koruyan uskudardaki muhteÅŸem yemekleri olan esnaf lokantasi.	FOOD#QUALITY
Esnaf lokantasi na gÃ¶re fiyatlarÄ± pahali ve kredi kartÄ± geÃ§miyor.	RESTAURANT#PRICES SERVICE#GENERAL
Ancak yemekleri gerÃ§ekten Ã§ok lezzetli.	FOOD#QUALITY
tatlilardan da irmik helvasÄ± ve fÄ±rÄ±nda sutlaci Ã¶neririm.	FOOD#QUALITY FOOD#QUALITY
YÄ±llardÄ±r Ä°stanbul'daki favori pizzacÄ±m.	RESTAURANT#GENERAL
Ben gittiÄŸimde bir pizzayÄ± hiÃ§ bir zaman kendim bitiremiyorum.	FOOD#STYLE_OPTIONS
Mesela 3 kiÅŸiysek genelde 2 pizza sÃ¶ylÃ¼yoruz.	
Birden Ã§ok pizza denemek adÄ±na pizzanÄ±n iki yarÄ±sÄ±nÄ± farklÄ± yaptÄ±rÄ±n derim.	FOOD#STYLE_OPTIONS
Servis porsiyonlar Ã§ok Ã§ok kÃ¶tÃ¼.	SERVICE#GENERAL FOOD#STYLE_OPTIONS
Nerde Bebek ÅŸubesi nerde burasÄ± tek gÃ¼zel yanÄ± caddenin bir arka sokaÄŸÄ±nda yeÅŸilliklerin iÃ§inde bahÃ§esinin olmasÄ±	AMBIENCE#GENERAL
Turk kahvesÄ±nÄ±n Ä±cÄ±nden kocaman bÃ¶cek Ã§Ä±ktÄ±.	DRINKS#QUALITY
KahveyÄ± bÄ±tÄ±rdÄ±ÄŸÄ±nÄ±zde dÄ±bÄ±ndekÄ± bocekle karsilasiyorsunuz!	DRINKS#QUALITY
Yemekleri hesap edin artÄ±k!	FOOD#QUALITY
Bir daha asla!	RESTAURANT#GENERAL
Nedendir bilmiyorum ama burayÄ± Ã§ok seviyorum.	RESTAURANT#GENERAL
Lynchburgleri Ã§ok gÃ¼zel.	DRINKS#QUALITY
Cin li kokteylleri de denemeye deÄŸer ama arkadaÅŸ bi jager mojito yapamÄ±yorsunuz.	DRINKS#QUALITY DRINKS#QUALITY
Otur , 0 !	RESTAURANT#GENERAL
AlkollÃ¼ iÃ§ki almadiginiz bir restda adam basi 80/90 tl hesap cookk fazla ,Ã¼stelik gayet az yedik .	RESTAURANT#PRICES
Lezzet iyi ama fiyatla orantili degil ,Porsiyonlar az,personel iyi .	SERVICE#GENERAL FOOD#STYLE_OPTIONS FOOD#PRICES FOOD#QUALITY
Manzara gÃ¼zel.	AMBIENCE#GENERAL
Kurucesmede olmasÄ±na raÄŸmen pek bir derme catma mekan.	AMBIENCE#GENERAL
SÄ±kÄ±ÅŸ SÄ±kÄ±ÅŸ yerlestirilmis masalardan dolayi ortam Ã§ok ugultulu maalesef.	AMBIENCE#GENERAL
Ã‡ok daha keyifli bir yer olabilirdi.	AMBIENCE#GENERAL
O gÃ¼rÃ¼ltÃ¼ ortamdan sonra tekrar gidecegimi sanmÄ±yorum.	AMBIENCE#GENERAL
Ä°thal peynir tabaÄŸÄ±ndaki peynirler Ã§ok yetersiz, Ã§oÄŸu ithal bile deÄŸil.	FOOD#QUALITY
BÃ¶ylesi bir mekan iÃ§in fiyat ortalamanÄ±n Ã¼stÃ¼nde kalmÄ±ÅŸ.	RESTAURANT#PRICES
AÃ§Ä±k ortamda yemek isteyenler iÃ§in gÃ¼zel bir ortam.	AMBIENCE#GENERAL
BahÃ§esinde sakince yemeÄŸinizi yiyebilirsiniz.	AMBIENCE#GENERAL
Kuzu sisleri ve lahmacunlari guzeldi...	FOOD#QUALITY
Serviste aksamalar var.	SERVICE#GENERAL
garsonlar sÃ¼rekli bir ÅŸey dÃ¼ÅŸÃ¼rÃ¼yor...	SERVICE#GENERAL
Kahvaltisi bol cesitli doyurucu hatta genelde biteremiyosunuz fiyati biraz daha uygun olabilirdi calisanlar guler yuzlu ama bulundugu alan ve masalar daha genis olsa daha rahat oturup keyifle kahvaltimizi edebiliriz	AMBIENCE#GENERAL SERVICE#GENERAL FOOD#STYLE_OPTIONS FOOD#PRICES
Merkezi konumu ve geniÅŸ menÃ¼sÃ¼ nedeniyle KadÄ±kÃ¶y'de Ã§ok tercih edilen, Ã§oÄŸu zaman dÄ±ÅŸarÄ±da yer bile bulamayacaÄŸÄ±nÄ±z mekan.	LOCATION#GENERAL FOOD#STYLE_OPTIONS
Eskiden Midpoint-House Cafe gibi mekanlarÄ±n sunduÄŸu menÃ¼leri daha uygun fiyata sunduÄŸundan tercih ediyorduk.	
Fakat son iki gidiÅŸimde Ã§ok pahalanmÄ±ÅŸ buldum.	RESTAURANT#PRICES
Yemeklerde bugÃ¼ne dek bir sÄ±kÄ±ntÄ±ya rastlamadÄ±m, ama Ã§ok lezzetli yapÄ±yorlar diyebileceÄŸim bir tek cajun tavuk var.	FOOD#QUALITY FOOD#QUALITY
Åimdilerde gÃ¶zÃ¼mde ancak ortalama bir mekan yani.	RESTAURANT#GENERAL
Tuzla balÄ±kÃ§Ä±sÄ±nÄ±n kÃ¶klÃ¼ mÃ¼ÅŸterisiyimdir.	RESTAURANT#GENERAL
Ä°lk aÃ§Ä±ldÄ±ÄŸÄ± gÃ¼nden bu gÃ¼nÃ¼ne gelir giderim.	RESTAURANT#GENERAL
FiyatlarÄ± gayet uygun olan yer bulmanÄ±n bir o kadar zor olduÄŸu ÅŸirin bir dÃ¼kkandan buralara kadar kÄ±sa bir sÃ¼rede gelmiÅŸ bir mekanÄ±mÄ±zdÄ±r.	AMBIENCE#GENERAL RESTAURANT#PRICES
Ama maalesef eski lezzet mi?	FOOD#QUALITY
Yok.	
Mekan ne kadar Ã§ok bÃ¼yÃ¼dÃ¼yse kalite o kadar dÃ¼ÅŸtÃ¼.	RESTAURANT#GENERAL
Ah be Sezgin Abi eski lezzetine hasretiz	FOOD#QUALITY
beÅŸiktaÅŸa otobÃ¼sle zincirlikuyudan geldiÄŸinizde gÃ¶zÃ¼nÃ¼ze direk Ã§arpan bir mekan.	LOCATION#GENERAL
pideleri iyi hizmetide bence Ã¼st kat terasÄ± Ã§ok daha iyi bÃ¼tÃ¼k kalabalÄ±k gÃ¶zÃ¼nÃ¼zÃ¼n Ã¶nÃ¼nden akÄ±yor resmen hemen yanÄ±ndaki aÄŸaÃ§ ilede farklÄ± bir hava katÄ±yor	SERVICE#GENERAL FOOD#QUALITY AMBIENCE#GENERAL
Bahariyede gezerken yemek yemek icin buraya gelebilirsiniz mekan guzel sik menu de cesitli gayet.	AMBIENCE#GENERAL FOOD#STYLE_OPTIONS
Fiyatlar da cok pahali degil ortalama duruyordu	RESTAURANT#PRICES
Cookshop diyince aklima ilk gelen Magnolia oluyor.	FOOD#QUALITY
Buraya gelipte bu tatliyi denemeden gitmeyin.	FOOD#QUALITY
Makarnalardan patlicanli,zeytinli penne guzel.	FOOD#QUALITY
Arkadasim lasagne yedi ama pek begenmedi.	FOOD#QUALITY
Servisin gelistirilmesi gerek siparis almaya gec geliyorlar.	SERVICE#GENERAL SERVICE#GENERAL
Sadece adi num num - Hem Gmall hem Kanyon denedim ama olmadi.	RESTAURANT#GENERAL
Yemekler basarisiz, menÃ¼ zengin, servis de basarili ama ilk aÃ§ildigindaki lezzet kalitesini bozdu.	FOOD#QUALITY FOOD#STYLE_OPTIONS SERVICE#GENERAL
Kurufasulye ve SÃ¼tlaÃ§ - SÃ¼rekli gittigim yerlerden biri.	FOOD#QUALITY
Kendileri Rize'den, fasulyeleri Ispir'den...	
Tereyagini da manzarayla karistirinca, yeme de yaninda yat...	FOOD#QUALITY AMBIENCE#GENERAL
Bir de Ã¼zerine bolca findik dÃ¶kÃ¼lmÃ¼s firin sÃ¼tlaci yedin mi daha ne olsun.	FOOD#QUALITY
Ideal...	RESTAURANT#GENERAL
- Tuzla sahilinde kafede oturup bir seyler iÃ§mek iÃ§in ideal bir yer.	LOCATION#GENERAL
KÃ¼nefesi dÃ¼sÃ¼ndÃ¼gÃ¼mden gÃ¼zelmis.	FOOD#QUALITY
Bir Hatay kÃ¼nefesiyle kiyaslamasam tabi ki ama lezzetliydi.	FOOD#QUALITY
Ã‡ayi, sahlepi, kÃ¼nefesi ve dondurmasi Ã¶nerilebilir.	DRINKS#QUALITY DRINKS#QUALITY FOOD#QUALITY
Limonatasi ev yapimi deniyor hatta iÃ§inde nane yapragi vs. dÃ¼z limonata gelince sorduk nane yapragini su anda yok dediler.	DRINKS#STYLE_OPTIONS
Biz sormadan getirdigimizde bilgilendirmesi lazimdi.	SERVICE#GENERAL
Tabi bunlar ufak tefek seyler.	
Yine de Tuzla'da ugrak olunabilecek bir mekan.	RESTAURANT#GENERAL
Mis gibi Uskudar ;) - Dilruba'ya Ã§ikis yolu zorlu, yorucu olsa da nargilesi iÃ§in gidilmeye deger.	DRINKS#QUALITY LOCATION#GENERAL
Hele kebaplari enfes.	FOOD#QUALITY
Sabahlari ise 100 Ã§esit kahvaltisiyla essiz manzara birlesince insani rahatlatmaya yetiyor.	AMBIENCE#GENERAL FOOD#STYLE_OPTIONS
GÃ¶rÃ¼lmesi gereken, kaliteli bir yer;)	RESTAURANT#GENERAL
DÃ¼n ailece essiz lezzetleri tatdigimiz Mabeyn deydik.	FOOD#QUALITY
Tatlilar muhtesemdi.	FOOD#QUALITY
Hesap gelene kadar tadimizda Ã§ok iyiydi.	RESTAURANT#PRICES
342 TL Ã§ok fazla.	RESTAURANT#PRICES
IÃ§ki servisi kaldirilmis olmasi garibime gitti aÃ§ikcasi.	DRINKS#STYLE_OPTIONS
Degisik pide tÃ¼rleri caniniz Ã§ekiyorsa denenebilir.	FOOD#STYLE_OPTIONS
Kusbasli kasarli pidesini denedik.	
eh iste.	RESTAURANT#GENERAL
ama Ã§ok pide yemeyenler iÃ§in gÃ¼zel diyebilirim.	FOOD#QUALITY
Ã§orbasi soguk geldi.	FOOD#QUALITY
Tadi pek yoktu.	FOOD#QUALITY
suflesi normal.	FOOD#QUALITY
Besiktas ta merkezi yerde.	LOCATION#GENERAL
Herkesin sÃ¼rekli ovdugu...	
Fakat yemekleri baya standart hatta bazÄ±larÄ± bi hayli kotu...	FOOD#QUALITY
Tavsiye edebileceÄŸim tek ÅŸeyi dondurmasÄ± olur sanÄ±rÄ±m.	FOOD#QUALITY
GeniÅŸ Ã§ay menÃ¼sÃ¼ ve bence alelade demlenen Ã§aylar.	DRINKS#STYLE_OPTIONS DRINKS#STYLE_OPTIONS
Kaliteli olabilirler ama ne gramÄ±na ne demleme sÃ¼resine ne de sÄ±caklÄ±ÄŸa dikkat edildiÄŸini sanmÄ±yorum.	DRINKS#QUALITY DRINKS#STYLE_OPTIONS
Bir paket Ã§ay alabildiÄŸim Ã¼crete daha iyi bir ÅŸey beklerdim.	DRINKS#PRICES DRINKS#QUALITY
TatlÄ±larÄ± iÃ§in gelinebilir.	FOOD#QUALITY
Miss Pizza "Ã§ok iyi" olmasa da Ä°stanbul'da en iyiler arasÄ±nda sayÄ±labilir.	FOOD#QUALITY
DÄ±ÅŸarÄ±da yer vermiyorlar, iÃ§erisi boÅŸken yerimiz yok diyorlar, Ã–ÄŸlen 12'den biraz Ã¶nce gidince daha aÃ§Ä±lmadÄ±k diyorlar vb...	SERVICE#GENERAL
YemeÄŸi fena olmasa servisi nedeniyle hayatta uÄŸramayacaÄŸÄ±m yer.	FOOD#QUALITY RESTAURANT#GENERAL SERVICE#GENERAL
Ä°yi bir kaliteye bÃ¶yle bir hizmet hiÃ§ yakÄ±ÅŸmÄ±yor.	FOOD#QUALITY SERVICE#GENERAL
KullanÄ±lan malzemeler Ã§ok iyi deÄŸil ancak ortalamanÄ±n Ã¼stÃ¼ ve hamuru gayet iyi yapÄ±yorlar.	FOOD#QUALITY FOOD#QUALITY
PizzalarÄ± gayet doyurucu ve Ã§eÅŸitli.	FOOD#STYLE_OPTIONS
DeÄŸiÅŸik tatlarÄ± tatmak isteyenler iÃ§in iyi bir alternatif.	FOOD#STYLE_OPTIONS
Ã–zellikle kabaklÄ± pizzasÄ± gayet baÅŸarÄ±lÄ±.	FOOD#QUALITY
Servis konusunda ise ciddi sÄ±kÄ±ntÄ±larÄ± olduÄŸunu dÃ¼ÅŸÃ¼ndÃ¼ÄŸÃ¼m bir yer.	SERVICE#GENERAL
Her seferinde mutlaka bir problemle karÅŸÄ±laÅŸÄ±yoruz.	RESTAURANT#GENERAL
Ã‡alÄ±ÅŸanlar gerÃ§ekten burnundan kÄ±l aldÄ±rmÄ±yor.	SERVICE#GENERAL
Ã‡ok defa geri dÃ¶nmÃ¼ÅŸlÃ¼ÄŸÃ¼m de vardÄ±r.	RESTAURANT#GENERAL
Manzara konum Ã§ok Ã§ok gÃ¼zel.	LOCATION#GENERAL AMBIENCE#GENERAL
BoÄŸazda balÄ±k iÃ§in Ä°stanbul'daki belli baÅŸlÄ± yerlerden olmasÄ±na raÄŸmen bÃ¶yle bir manzara iÃ§in lezzet biraz daha arttiralabilinir diye dÃ¼ÅŸÃ¼nÃ¼yorum.	AMBIENCE#GENERAL FOOD#QUALITY
Fiyatlar yÃ¼ksek ama gerÃ§ek boÄŸazda balÄ±ÄŸÄ±n bedeli var, ambians ve konum dolayÄ±sÄ± ile fiyatlara laf sÃ¶ylemek doÄŸru deÄŸil.	LOCATION#GENERAL AMBIENCE#GENERAL RESTAURANT#PRICES
BoÄŸazda balÄ±klÄ± romantik akÅŸam yemeÄŸi iÃ§in ...	AMBIENCE#GENERAL
Happy moon's burger ve normal burger denedik.	
Once kirk saat istegimiz soslari bekledik cunku tum soslar baskalari tarafindan kullaniliyordu.	SERVICE#GENERAL
Sorum su ki alti ustu bir mayonez ne kadar bulunmasi zor olabilir ya da maliyeti nedir ki bu kadar az alinir?	FOOD#STYLE_OPTIONS
Yemege gelince ise tatsiz tutsuz bir yemekti begenmedik.	FOOD#QUALITY
Yemek bitince hadi kalkin tavirlarina girildi.	SERVICE#GENERAL
Baska bir sey almiyor musunuz?	
Ne zaman kalkiyorsunuz?	
Ozetle uzatmadan musteriye yoluncak kaz gozuyle bakilmaktadir.	SERVICE#GENERAL
Bendemi var bir hoÅŸnutsuzluk anlamadÄ±m.	RESTAURANT#GENERAL
Bereketli bir mekan hafta iÃ§i,cumartesi kuyruk kapÄ±da.	RESTAURANT#GENERAL
Lakin bir kez soÄŸuk gelen Ã§orbayÄ± garsona sÃ¶ylediÄŸimde hiÃ§ oralÄ± olmadÄ±.	SERVICE#GENERAL
anlaÅŸÄ±lan mÃ¼essesede bir doymuÅŸluk var.	RESTAURANT#GENERAL
FÄ±sÄ±ltÄ±lara gÃ¶re Avrupa yakasÄ±ndada yer arayÄ±ÅŸlarÄ± varmÄ±ÅŸ.	
Bence orada en leziz olan lavaÅŸ.	FOOD#QUALITY
lavaÅŸ yediriyor gibi.	FOOD#QUALITY FOOD#QUALITY
DÃ¶neri Ã§ok beni sarmadÄ±.	FOOD#QUALITY
En Ã¶nemli Ã¶zelliÄŸi olan dÃ¶neri hariÃ§ geri kalan her ÅŸey iyiydi.	FOOD#QUALITY RESTAURANT#GENERAL
Yemek Ã¶ncesi ikramlar, garsonlarÄ±n ilgisi ve servis hÄ±zÄ± gÃ¼zeldi.	SERVICE#GENERAL SERVICE#GENERAL SERVICE#GENERAL
Ama dÃ¶neri methedildiÄŸi kadar deÄŸilmiÅŸ.	FOOD#QUALITY
ManzarasÄ± sÃ¼per, zaten sÃ¼per olan baÅŸka birÅŸeyde yok.	RESTAURANT#GENERAL AMBIENCE#GENERAL
DiÄŸer lezzetlerin tamamÄ± standart.	FOOD#QUALITY
Bu lezzetlere gÃ¶re uygÄ±lanan fiyatlarda pahalÄ± bence.	FOOD#PRICES
Manzara parasÄ± eklenmiÅŸ yiyeceklerin Ã¼zerine	FOOD#PRICES
TÃ¼nel'de ev yemeÄŸi yemek iÃ§in gÃ¼zel bir alternatif ve lezzetli olsa da rahatlÄ±k aÃ§Ä±sÄ±ndan bana iyi bir hissiyat vermemiÅŸti, hemen yemek yiyip kalkmalÄ±k mekanlardan Ã§Ã¼nkÃ¼ masa sayÄ±sÄ± Ã§ok az ve masanÄ± yÃ¼ksek ihtimalle baÅŸkalarÄ±yla paylaÅŸÄ±yorsun.	AMBIENCE#GENERAL FOOD#QUALITY
Yine de ayda yÄ±lda bir gidilebilir.	RESTAURANT#GENERAL
Zeytinyagli yemekleri cok basarili ve her yerde olan klasik yemekler yerine farkli tatlar var.	FOOD#STYLE_OPTIONS FOOD#QUALITY
Oldukca da bol kepceden hizmet veriyorlar ve 5cesit zeytinyagli icin 13-14tl oduyorsunuz.	FOOD#PRICES FOOD#STYLE_OPTIONS
ogle yemeklerinde hele de yazin favori yerlerimden,ama maalesef ufak bir mekan oldugu icin yer bulmak zor olabiliyor ama birazcik beklerseniz imkansiz degil	FOOD#QUALITY SERVICE#GENERAL
ManzarasÄ± sÃ¼per.	AMBIENCE#GENERAL
GerÃ§ekten Ã§ok gÃ¼zel bir konumda yer alÄ±yor.	LOCATION#GENERAL
Servisi hÄ±zlÄ±.	SERVICE#GENERAL
Ne zaman gitsek gÃ¼ler yÃ¼zle ayrÄ±lÄ±yoruz.	RESTAURANT#GENERAL
KÃ¶fteleri de lezzetli.	FOOD#QUALITY
Taksimin kalabalik dar sokaklarindan kucucuk bir kapidan girip ulastiginiz yemyesil bir bahce adeta kucuk bir supriz :	AMBIENCE#GENERAL
) biz burayi cok sevdik cok romantik cok tatli.	AMBIENCE#GENERAL RESTAURANT#GENERAL
Tek kusuru masalar biraz yakin birbirine.	AMBIENCE#GENERAL
Kirmizi limonata ve limon vitamin tercih ettik ve ikisine de bayildik.	DRINKS#QUALITY DRINKS#QUALITY
Mutlaka gelin gorun.	RESTAURANT#GENERAL
Manzarasi mukkemmel denize sifir olmasi sebebiyle.	AMBIENCE#GENERAL
Bahcesi huzurlu.	AMBIENCE#GENERAL
Ä°cerisi icin ayni seyi soyleyemiycm temiz bulmuyorum.	AMBIENCE#GENERAL
Self servis olayi sÄ±kÄ±cÄ±.	SERVICE#GENERAL
Bir yandan iyi pesinizde dolanan garsonlar yok.	SERVICE#GENERAL
Girip hava almak icin oturabilceginiz br yer.	AMBIENCE#GENERAL
Ã‡ok kalabalÄ±k olduÄŸundan pek sohbete uygun deÄŸil, ancak mekan gayet gÃ¼zel, iÃ§ kÄ±sÄ±m Ã§ok gÃ¼zel kokuyor.	AMBIENCE#GENERAL AMBIENCE#GENERAL
Ama kalabalÄ±k ve gÃ¼rÃ¼ltÃ¼den dolayÄ± Ã§ok fazla duramadÄ±k.	AMBIENCE#GENERAL
Eski performansini ariyoruz - Baslarda mÃ¼ptelasi oldugum ama son zamanlarda kalitesi oldukÃ§a dÃ¼sen bir mekan.	RESTAURANT#GENERAL
Ilk kez yiyen iÃ§in mÃ¼kemmel ama ilk aÃ§ildigindaki lezzeti kaybetti.	FOOD#QUALITY FOOD#QUALITY
En iyi konumlu Ã¶gretmenevi!	LOCATION#GENERAL
- Anadolu Hisari'nin hemen yanindaki Sabanci Ã–gretmenevi, herkesin kullanimina aÃ§ik olan bir tesis.	RESTAURANT#GENERAL
Toplamda 4 salon ve bir kafeteryadan olusan tesiste uygun fiyat hizmet almak ve 4 ayri salonda dÃ¼gÃ¼n, nisan, okul yemegi, toplanti gibi organizasyonlar gerÃ§eklestirmek mÃ¼mkÃ¼n.	RESTAURANT#PRICES
Kafeteryasinin self servis olmasi bir eksi gibi gÃ¶rÃ¼nse de Bogaz'daki Ã§ay keyfi tartisilmaz!	AMBIENCE#GENERAL SERVICE#GENERAL
Tamam yemekler guzel de, pilav da kurufasulye de soguk!	FOOD#STYLE_OPTIONS FOOD#QUALITY
Cok kalabalik oldugu icin servis de aksiyor tabii, calisanlar bikkin.	SERVICE#GENERAL
Bir kere gittim, bir daha gitmem.	RESTAURANT#GENERAL
Hani sizi keyifli sohbet ortamlari ile bÃ¼tÃ¼nlestiren ve ardindan damakta biraktigi Lezzet ile mÃ¼davimi yapan yerler vardir!	AMBIENCE#GENERAL FOOD#QUALITY
O adreslerden biridir!	
Pazar kahvaltilari benim IÃ§in mabeyin'dir.	FOOD#QUALITY
Namini duyup gittigim yerlerden ama mezeler gelince ortada nam falan kalmadi malesef.	FOOD#QUALITY
Ayrica sacma sapan hesapta gelip sonrasinda bahsisle calisan valenin para diye tutturmasida cabasi.	SERVICE#GENERAL RESTAURANT#PRICES
Begenmedim malesef.	RESTAURANT#GENERAL
Bize mi denk geldi bilmiyorum ama, uzun zamandÄ±r yediÄŸim en kÃ¶tÃ¼ yemeÄŸi burada yedim, Ã¼stÃ¼ne servis de Ã§ok Ã§ok kÃ¶tÃ¼ydÃ¼.	FOOD#QUALITY SERVICE#GENERAL
MenÃ¼nÃ¼n hiÃ§ bir Ã¶zelliÄŸi yok.	FOOD#STYLE_OPTIONS
Birbirinin kopyasÄ± olan, standart kafe yemekleriyle mÃ¼ÅŸteri kazÄ±klamaya Ã§alÄ±ÅŸan tipik yerlerden biri.	RESTAURANT#PRICES RESTAURANT#GENERAL FOOD#STYLE_OPTIONS
HisarÃ¼stÃ¼ne Ã§ok yakÄ±ÅŸan bir bar olmuÅŸ iÃ§ dizaynÄ±nÄ± Ã§ok gÃ¼zel yapmÄ±ÅŸlar ama kÄ±ÅŸ aylarÄ±nda biraz soÄŸuk olma problemi var :	AMBIENCE#GENERAL AMBIENCE#GENERAL
( 4 tarafÄ± cam olduÄŸu iÃ§in yeterince Ä±sÄ±tamÄ±yorlar.	AMBIENCE#GENERAL
YÄ±lbaÅŸÄ± iÃ§in 100 liraya sÄ±nÄ±rsÄ±z yabancÄ± alkollÃ¼ bir etkinlikleri olmasÄ± da Ã§ok gÃ¼zel :	DRINKS#STYLE_OPTIONS
Hamburgerini pek beÄŸenmedim ama diÄŸer yemekleri lezzetli olabilir belki.	FOOD#QUALITY FOOD#QUALITY
SÃ¼rekli kalabalÄ±k olan bir mekan.	AMBIENCE#GENERAL
Ãœniversiteliler Ã§ok sÄ±k uÄŸruyor.	
KadÄ±kÃ¶ydeki gÃ¶zde mekanlardan biri	RESTAURANT#GENERAL
Ã‡ay denilince akla ilk gelen yer:	RESTAURANT#GENERAL
)) 60'a yakÄ±n Ã§eÅŸitte Ã§aydan birini mutlaka seviceksiniz:	DRINKS#STYLE_OPTIONS
) ben karamel aramalÄ± Ã§ayÄ± Ã§ok sevdim adÄ±nÄ± hatÄ±rlamasamda siz iÃ§inde karamel var dediÄŸinizde tek gelicek o olucaktÄ±r:	DRINKS#QUALITY
)) mekan inanÄ±lmaz keyifli iÃ§erdeki koltuklardan kalkmak istemiyor insan:	AMBIENCE#GENERAL
Kesinlikle verdiÄŸim puanÄ± hakeden bir mekan.	RESTAURANT#GENERAL
KÃ¼Ã§Ã¼k ÅŸirin bir konsepte sahip.	AMBIENCE#GENERAL
Pizza Fagotto favori lezzetim ve daha iyisini yiyene kadar benim iÃ§in en iyi pizza bu.	FOOD#QUALITY
DÃ¼sen kalite - Eskiden ne Ã§ok severdim patlicanli gÃ¼veÃ§ kebabini...	RESTAURANT#GENERAL
Yakinlarda gittim servis berbat.	SERVICE#GENERAL
Fiyat yÃ¼ksek, kart geÃ§miyor...	RESTAURANT#PRICES
Yine de sorbe dondurmasi gÃ¼zeldir.	FOOD#QUALITY
KÄ±sÄ±klÄ±'ya yakÄ±n olan mekanÄ±n Åatobiryan isimli etini deneyin.	FOOD#QUALITY
YalnÄ±z Ã¶nceden arayÄ±n, var mÄ± kaldÄ± mÄ± diye sorun.	
Ã–zel bir sunumla masanÄ±za geliyor.	FOOD#STYLE_OPTIONS
Bir de mantar Ã§anaklarÄ± denenebilir.	FOOD#QUALITY
Harika manzara, gÃ¼zel lezzetler - Manzarasi ve yiyecekleri son derece gÃ¼zel, her Ã§esit yiyecek mevcut ve son derece lezzetli fiyatlari ise Ã§ok Ã§ok uygun.	FOOD#STYLE_OPTIONS FOOD#QUALITY AMBIENCE#GENERAL FOOD#PRICES
Halka aÃ§ik olmasi ise son derece gÃ¼zel.	RESTAURANT#GENERAL
Ã‡ok kalabalik olusu ve yer bulamamak sikinti olsa da gidilmesi gereken yerlerden biri.	RESTAURANT#GENERAL AMBIENCE#GENERAL
Hisarustu'ndeki en genis mekan olmasina ragmen ferah bir yer degil.	AMBIENCE#GENERAL
Kalabalik gruplar icin uygun, bu acidan buyuk avantaj sagliyor.	AMBIENCE#GENERAL
Belli bir saate kadar bistro seklinde olusu da guzel.	RESTAURANT#GENERAL
Yazin camekan olmasi hos ancak kisin donmustuk.	AMBIENCE#GENERAL AMBIENCE#GENERAL
Ilk kez kÄ±s gecirmesinden midir bilmem ama su da akiyordu tepemizden.	AMBIENCE#GENERAL
Kendi biralarindan denenmeli, guzel biralar vardi.	DRINKS#QUALITY
Isterseniz denemek icin farkli biralardan kucuk bardaklarda alabiliyorsunuz.	DRINKS#STYLE_OPTIONS
Keyifli bir ortam ve cok da kalabalik degildi, tavsiye edilir	AMBIENCE#GENERAL
KadÄ±kÃ¶yde hemen hemen gitmediÄŸim bar kalmadÄ± diyebilirim.	
Alkol Ã§eÅŸitliliÄŸi, yemekleri, dekorasyonu, barmeni, mÃ¼ÅŸteri profili olarak benim iÃ§in KadÄ±kÃ¶y'dekl en iyi mekandÄ±r.	DRINKS#STYLE_OPTIONS SERVICE#GENERAL AMBIENCE#GENERAL AMBIENCE#GENERAL FOOD#QUALITY
Ã‡alÄ±ÅŸanlarÄ±n, iÅŸletmecinin hatta sahibinin misafirperverliÄŸi ve samimiyetini baÅŸka bir mekanda bulabileceÄŸinizi sanmÄ±yorum.	SERVICE#GENERAL SERVICE#GENERAL SERVICE#GENERAL
Her daim gidilebilecek bir mekan.	RESTAURANT#GENERAL
YalnÄ±z, maÃ§ gÃ¼nlerinde bir gÃ¼n Ã¶nceden rezervasyon yapmalÄ±sÄ±nÄ±z.	
MaÃ§ gÃ¼nÃ¼ yer bulmanÄ±z Ã§ok zor.	
KadÄ±kÃ¶y'Ã¼n kemik mekanÄ±.	RESTAURANT#GENERAL
Hep klasik kaliteyi bulabilmeniz mÃ¼mkÃ¼n.	RESTAURANT#GENERAL
Hafta sonu kahvaltÄ±sÄ± iÃ§in de gÃ¶nÃ¼l rahatlÄ±ÄŸÄ±yla tercih edebileceÄŸiniz bir mekan	FOOD#QUALITY
Ramazan ayÄ±nda gitme fÄ±rsatÄ± buldum yeÅŸillik iÃ§inde hoÅŸ ve dÃ¼zgÃ¼n bir mekan.	AMBIENCE#GENERAL
Ä°ftar Ã¶ncesi ve sonrasÄ±nda gÃ¼zel mÃ¼zik ziyafeti sundular.	AMBIENCE#GENERAL
Esas konumuz olan yemeklere gelince Ã§ok pozitif olamaycaÄŸÄ±m.	FOOD#QUALITY
ben aynÄ± fiyatlara Ã§ok daha lezzetli yemekler yiyorum bu ÅŸehirde.	FOOD#QUALITY
MekanÄ± bilmeyeniniz yoktur.	RESTAURANT#GENERAL
KÄ±z kulesi karÅŸÄ±sÄ±nda eÅŸÅŸsiz bir manzara , meÅŸhur olduktan sonra tabiki her yer gibi lezzet kalitesi dÃ¼ÅŸÃ¼yor.	FOOD#QUALITY AMBIENCE#GENERAL
Bu konuda her mekan bÃ¶yledir	
Telefonla aradÄ±ÄŸÄ±mda rezervasyon alamÄ±yoruz deyip, oraya gittiÄŸimde istediÄŸim masaya "orasÄ± rezerve beyefendi" diyerek oturtmayan, insanlarÄ± gÃ¶rÃ¼nÃ¼ÅŸÃ¼ne gÃ¶re aÃ§Ä±kÃ§a tersleyen ukala ve sevimsiz garsonlara sahip.	SERVICE#GENERAL
Big Chefs isminin verdiÄŸi gÃ¼ven ve muhitinde rakibi olmamasÄ± yÃ¼zÃ¼nden sÃ¼rekli dolu olabilir ama bÃ¶yle giderlerse Ã§ok mÃ¼ÅŸteri kaybederler.	SERVICE#GENERAL
Hamburgerlerini seviyordum ama son deneyimim beni mutlu etmedi.	FOOD#QUALITY RESTAURANT#GENERAL
Bir kez daha sans vereceÄŸim.	RESTAURANT#GENERAL
Servisi bazen iyi, bazen kÃ¶tÃ¼.	SERVICE#GENERAL
Mekan tasarÄ±mÄ± iyi.	AMBIENCE#GENERAL
Ofiste bir tatli kriziyle Tavuk GÃ¶gsÃ¼ ve Kabak Tatlisi siparis ettik.	
Ikisi de birbirinden lezzetli.	FOOD#QUALITY
Hatta sanirim hayatimda yedigim en lezzetli Tavuk GÃ¶gsÃ¼'nÃ¼ yedim.	FOOD#QUALITY
Keske fotograf Ã§ekmeye de firsatimiz olsaydi.	
) Bu arada hizli servis iÃ§in tesekkÃ¼r ediyoruz.	SERVICE#GENERAL
Tatli krizi ancak bÃ¶yle sahane bastirilabilirdi.	FOOD#QUALITY
mekan emniyet mah cafe ve restorant olmak sartiyla iki bÃ¶lÃ¼mden olusuyor her ikisinide denedim gayet genel itibari ile gÃ¼zel bir mekan kuzu bonfilesi gÃ¼zeldi ilgi normaldi Ã§ok kalabalik bir mekan iÃ§ecekler genel olarak gÃ¼zeldi giriste mini sarkÃ¼teride alisverise isik tutuyor gÃ¼zeldi fiyatlar birazcik fazla	SERVICE#GENERAL RESTAURANT#PRICES RESTAURANT#GENERAL RESTAURANT#GENERAL DRINKS#QUALITY FOOD#QUALITY
gerÃ§ekten bir Ã¶zelligi olmayan Ã§esidi bol konumu itibari ile talep gÃ¶ren Ã§ok sikisik havasiz normal bir mekan fiyatlar hayli yÃ¼ksek sÃ¼per bir Ã¶zelligi olan bir yemegi varsa sÃ¶yleyin arkadaslar	LOCATION#GENERAL RESTAURANT#PRICES AMBIENCE#GENERAL
Servisi ve yemekleri bu kadar kÃ¶tÃ¼ restorant bulmak istanbulda zor olsa gerek.	SERVICE#GENERAL FOOD#QUALITY
Yenmeyecek kadar kÃ¶tÃ¼ kebaplari, ukala garsonu ve en lÃ¼ks restoranda Ã¶deyecegini alkollÃ¼ yemek fiyatiyla karsilasirsiniz.	FOOD#QUALITY SERVICE#GENERAL RESTAURANT#PRICES
Belediye bu isletmenin ruhsatini acil olarak iptal etmelidir.	RESTAURANT#GENERAL
Herseyi birakin manzarasi yeter zaten.	AMBIENCE#GENERAL
Denize sifir hatta oyle ki gecen gemilerden dolayi olusan dalgalar sizi islatir mi acaba diye bir korkuya kapiliyorsunuz ;) kahve ic manzarayi yani bogazi seyret yetti de artti bile.	AMBIENCE#GENERAL
Sadece manzarasÄ± baÅŸka bence artÄ± deÄŸeri yok.	AMBIENCE#GENERAL RESTAURANT#GENERAL
O da eÄŸer yer bulabilirseniz.	SERVICE#GENERAL
Ã‡alÄ±ÅŸanlarÄ± Ã§ok kaba.	SERVICE#GENERAL
Sizi saatlerce sÄ±rada bekletip Ã¶nÃ¼nÃ¼ze baÅŸkalarÄ±nÄ± alabiliyor.	SERVICE#GENERAL
Passion fruit'lu dondurmasÄ± ve iÃ§eceÄŸini beÄŸendim.	DRINKS#QUALITY FOOD#QUALITY
AÅŸÅŸk-Ä± Memnu vasat bir tada sahip bence.	FOOD#QUALITY
Bir daha gider miyim?	RESTAURANT#GENERAL
Bilmiyorum.	
Fena deÄŸil ama menemen iÃ§in fiyat yÃ¼ksek.	FOOD#QUALITY FOOD#PRICES
Bu arada porsiyon da oldukÃ§a bÃ¼yÃ¼k, iki kiÅŸiye rahatlÄ±kla yeter.	FOOD#STYLE_OPTIONS
Ã‡ok sulu olduÄŸu iÃ§in zaten bol ekmekle yeniyor.	FOOD#STYLE_OPTIONS
Tam anlamiyla harika bir mekan ic mekan konseptiyle tam kis mevsimine uygun ozellikle kisin kahvalti icin guzel bir mekan ariyorsaniz buraya bi ugrayin derim	AMBIENCE#GENERAL AMBIENCE#GENERAL
HayÄ±r.	
Ã–zellikle gÃ¼zel bir havada gidiyorsanÄ±z deniz kÄ±yÄ±sÄ±ndaki masalarÄ±nda oturmak iÃ§in epey bi sÄ±ra bekleyebilirsiniz.	SERVICE#GENERAL
Mekan kÃ¼Ã§Ã¼k ama ÅŸirin, aÅŸk-Ä± memnu'yu daha Ã¶nce hiÃ§ bitiremedim ama gerÃ§ekten Ã§ok gÃ¼zel bir tadÄ± var.	FOOD#QUALITY AMBIENCE#GENERAL
Servis sÄ±kÄ±ntÄ±lÄ±ydÄ±, sevemedim.	SERVICE#GENERAL
AyrÄ±ca bahsettiÄŸim meÅŸhur tatlÄ± 21 tl	FOOD#PRICES
AslÄ±nda doymuÅŸtuk ama gÃ¶zÃ¼mÃ¼zÃ¼n aÃ§lÄ±ÄŸÄ±ndan patatesli mantÄ±sÄ±nÄ± da denedik gayet iyiydi ama ekstra bir Ã¶zelliÄŸi yoktu.	FOOD#QUALITY
Ä°Ã§erisi biraz yemek kokuyordu ve Ã§alÄ±ÅŸanlarÄ±nda gereksiz bir negatif enerji vardÄ±.	SERVICE#GENERAL AMBIENCE#GENERAL
Ä°nÅŸallah sadece o gÃ¼ne Ã¶zgÃ¼ bir negatifliktir Ã§Ã¼nkÃ¼ FÄ±ccÄ±n'Ä±n tadÄ± damaÄŸÄ±mda yine gitmek gerek.	RESTAURANT#GENERAL RESTAURANT#GENERAL
Fiyatlar gayet uygun.	RESTAURANT#PRICES
Bu civarda gÃ¼zel kahvaltÄ± edilecek yerlerden diye girdik ama durum pek Ã¶yle olmadÄ±.	RESTAURANT#GENERAL
Menemeni gÃ¼zel denebilir.	FOOD#QUALITY
Ama kahvaltÄ± seÃ§enekleri zayÄ±f zira fotoÄŸraftaki sÃ¶zde zengin kahvaltÄ± tabaÄŸÄ± karar sizin.	FOOD#STYLE_OPTIONS
Zengini buysa normali nasÄ±l olur.	FOOD#STYLE_OPTIONS
Ã‡ok Ã¶vÃ¼lÃ¼p merak ettiÄŸimiz ama yine piÅŸman olduÄŸumuz bir yer.	RESTAURANT#GENERAL
Bu kadar popÃ¼lersin o kÃ¶tÃ¼ durumdaki mekanÄ± tadilattan geÃ§irmek Ã§ok mu zor.	AMBIENCE#GENERAL
AdÄ±yla meÅŸhur menemen yiyeyim dedim domates kabuÄŸu ayÄ±klamaktan hiÃ§bir ÅŸey anlamadÄ±m.	FOOD#QUALITY
O kabuklarÄ± soymak ne kadar zor ki?	FOOD#STYLE_OPTIONS
Hele de adÄ±nÄ± aldÄ±ÄŸÄ±n bir ÅŸeyde.	
Sucuklu yumurtasÄ±nda da sucuklar fazla piÅŸmiÅŸti.	FOOD#QUALITY
HerÅŸeyine kefil OlduÄŸum bir mekan.	RESTAURANT#GENERAL
GarsonlarÄ±ndan aÅŸÃ§Ä±larÄ±na kadar Ã§ok iyiler burada yediÄŸiniz yemekler ve tabaklarÄ±n taklidi bulabilirsiniz ama bu tadÄ± baÅŸka yerde bulamazsÄ±nÄ±z kardeÅŸler keep calm and eat from Happy Moons	FOOD#QUALITY SERVICE#GENERAL
AdÄ± Ã¼zerinde "menemeni" ile Ã¼nlÃ¼, sÄ±cak, samimi, esnaf restoranÄ±.	AMBIENCE#GENERAL
Menemeni leziz, balÄ± enfes ama Ã§ayÄ± iÃ§in olumlu bir yorum yapamayacaÄŸÄ±m.	FOOD#QUALITY DRINKS#QUALITY FOOD#QUALITY
KarÅŸÄ±sÄ±nda da lokantasÄ± bulunuyor ama ben size derim ki gidin menemen ve bal kaymakla gÃ¼zel bir kahvaltÄ± yapÄ±n.	FOOD#QUALITY
Fiyatlar da gayet uygun, ortalamanÄ±n altÄ±nda.	RESTAURANT#PRICES
Sampi, avarajda olsa da, otobÃ¼s yolculuÄŸu yapanlarÄ±n mutlaka uÄŸradÄ±ÄŸÄ± yerdir.	RESTAURANT#GENERAL
Pideleri Ã§eÅŸitli, daha Ã§ok Karadeniz pidesi tÃ¼rÃ¼nde.	FOOD#STYLE_OPTIONS
Ã–zellikle gitmekten Ã¶te, denk gelince gidileceklerden bence.	RESTAURANT#GENERAL
Happy moon's larÄ±n yÃ¼z karasÄ±.	RESTAURANT#GENERAL
Ã‡alÄ±ÅŸanlar Ã§ok kÃ¶tÃ¼.	SERVICE#GENERAL
Lezzet sÄ±fÄ±r.	FOOD#QUALITY
MenÃ¼de alkol bulundurmayan tek gereksiz happy moon's.	DRINKS#STYLE_OPTIONS
OlduÄŸu sokaktaki siz masada yemek yerken ki yanÄ±nÄ±za yapÄ±ÅŸanlarla da mÃ¼cedele edemesi cabasÄ±.	LOCATION#GENERAL
Kis aylarinda tercih sebebi - Ã–zellikle kisin bu kÃ¼tÃ¼k evde sahlep iÃ§mek oldukÃ§a gÃ¼zeldir.	AMBIENCE#GENERAL AMBIENCE#GENERAL
Aparatifleri de aÃ§liginizi yaristirmak iÃ§in birebirdir.	FOOD#QUALITY
Nargilesi de mevcut olan mekan genelde hep doludur.	DRINKS#STYLE_OPTIONS
Kuru fasÃ¼lye iÃ§in tercih etmek gerek diye dÃ¼sÃ¼nÃ¼lsede tereyagli pilavi Ã§ok daha dogal.	FOOD#QUALITY
Kuru hakikaten lezzetli ama iÃ§indeki yagin margarin oldugunu hissediyorum.	FOOD#QUALITY FOOD#QUALITY
Bu lezzetlerin yaninda verilen kÃ¼Ã§Ã¼k aci biberler bence sofranin favorisi.	FOOD#STYLE_OPTIONS
((( hayal kirikligi - Uzunlar'a ilk gittigimdeki tadi ikinci gidisimde bulamadim...	FOOD#QUALITY
Ilk gittigimde Ã§ok lezzetli gelen dÃ¼rÃ¼m 2. gidisimde tam bir fiyaskoydu Ã§ok yagli oldugundan yiyemedik arkadaslarla aÃ§ kaldik resmen :	FOOD#QUALITY FOOD#QUALITY
((( Mekanin kalabalik olmasindan mi kaynakliydi bu dikkatsizlik anlam veremedim, bu kadar Ã¶vgÃ¼ almasina ragmen bÃ¶yle olumsuz bir durum ilginÃ§ geldi.	RESTAURANT#GENERAL
Seyir terasi - Istanbul'u seyretmenin en Ã§ok keyif verdigi yerlerden biridir.	AMBIENCE#GENERAL AMBIENCE#GENERAL
Manzarasi sakinlestirir ve huzur verir.	AMBIENCE#GENERAL
Personel ilgilidir.	SERVICE#GENERAL
Burada kendinizi kÃ¶tÃ¼ hissetmezsiniz ve mutlu ayrilirsiniz.	RESTAURANT#GENERAL
Lezzetli yemekler, rahat ortam ve uygun fiyatlar.	RESTAURANT#PRICES FOOD#QUALITY AMBIENCE#GENERAL
Tek sorunu ulaÅŸÄ±mÄ± birazcÄ±k sÄ±kÄ±ntÄ±lÄ±.	LOCATION#GENERAL
Ã–zel aracÄ±mÄ±zla nereden gireceÄŸimizi pek kestiremedik ancak 10 dakikalÄ±k bir Ã§aba sonununda mekana ulaÅŸtÄ±k.	LOCATION#GENERAL
YemeÄŸin ardÄ±ndan cafe ortamÄ±na devam edebilirsiniz.	AMBIENCE#GENERAL
AynÄ± zamanda Tavla, okey gibi oyunlarÄ± da oynayabileceÄŸiniz bÃ¶lÃ¼mleri var.	RESTAURANT#GENERAL
Gayet kullanÄ±ÅŸlÄ± ve uygun.	RESTAURANT#GENERAL
YazÄ±n daha da gÃ¼zel olan mekan.	RESTAURANT#GENERAL
en sevdÄ±gÄ±m big chef ÅŸubesi arkadaÅŸlarÄ±nÄ±zla keyifli zaman geÃ§ireceÄŸiniz bu mekan gÃ¶ksunun incisi tekrar gidiceÄŸinizden emin olabilirsiniz	RESTAURANT#GENERAL
Manzaradan kurtaran bir mekan.	AMBIENCE#GENERAL RESTAURANT#GENERAL
Pek sevmedim acikcasi.	RESTAURANT#GENERAL
Kofteleri de cok cok mukemmel degil.	FOOD#QUALITY
Idare eder denilebilir.	RESTAURANT#GENERAL
Guler yuz yok.	SERVICE#GENERAL
Gurultulu ve aksam saatlerinde oldukca kalabalik oluyor.	AMBIENCE#GENERAL
OturduÄŸunuz sÃ¼rece sÃ¼rekli patlamÄ±ÅŸ mÄ±sÄ±r getiriyorlar.	SERVICE#GENERAL
DurmazsanÄ±z bir saat iÃ§inde yaklaÅŸÄ±k 10 kase falan yiyebilirsiniz.	FOOD#STYLE_OPTIONS
AyrÄ±ca en son Premier League maÃ§larÄ±nÄ± da veriyorlardÄ±.	SERVICE#GENERAL
Kuru fasulyenin lezzetine diyecek sÃ¶z yok, fiyatlar da makul sayÄ±lÄ±r ancak mekan dÃ¼ÄŸÃ¼n salonundan bozma.	AMBIENCE#GENERAL FOOD#QUALITY RESTAURANT#PRICES
En nihayetinde kuru fasulyeci ancak ortam daha zevkli hale getirilebilir.	AMBIENCE#GENERAL
Mekanin konumu Ã§ok muhtesem konsept, hizmet ve Ã¼rÃ¼nler vasat.	FOOD#QUALITY LOCATION#GENERAL SERVICE#GENERAL
- Anadolu hisarinda bir tarafi GÃ¶ksu Deresi diger tarafi Istanbul Bogazinin akip giden masmavi sulari ama hepsi bu kadar.	LOCATION#GENERAL RESTAURANT#GENERAL
Ben farkli zamanlarda gittim ama mekanin kimligi enerjisi bana hitap etmiyor...	RESTAURANT#GENERAL
Mutlaka mÃ¼davimleri vardir ama beni Ã§ekmiyor.	RESTAURANT#GENERAL
Ama bu mekan iyi bir isletmeci ile sÃ¶yle iyi bir sekilde elden geÃ§se Ã§ok iyi isler Ã§ikar buradan...	RESTAURANT#GENERAL SERVICE#GENERAL
Konum olarak aslinda Ã§ok gÃ¼zel bir yerde.	LOCATION#GENERAL
Belki mekanin Ã¼st kisminda otursaydik bÃ¼yÃ¼k bir ihtimal manzarada vardir ama biz maalesef otoparkta oturdugumuz iÃ§in arabadan ve agaÃ§tan bir sey gÃ¶remedik.	AMBIENCE#GENERAL
Sanirim ramazana Ã¶zel bir uygulamaydi bu otoparkta masa.	AMBIENCE#GENERAL
Eger gidecekseniz Ã¶zellikle mekanin Ã¼st katlarinda olmasini isteyin.	AMBIENCE#GENERAL
Lezzet konusunda da aman aman bir lezzeti yoktu.	FOOD#QUALITY
Manzarasi iÃ§in giderim diyorsaniz denenebilir.	AMBIENCE#GENERAL
IÃ§i gayet sikici, kredi karti geÃ§erli olmayan, Ã§orbayi kase yerine dÃ¼z tabakta servis eden, personeli asik suratli, etlerin sadece bir parÃ§a olarak geldigi ve neden bu kadar meshur oldugunu anlayamadigim gereksiz bir yer.	AMBIENCE#GENERAL RESTAURANT#GENERAL SERVICE#GENERAL FOOD#STYLE_OPTIONS
Son derece kotu servis, anlatilamayacak kadar hizmet sekorunden uzak, baska bir dunyada personel.	SERVICE#GENERAL SERVICE#GENERAL
Bir kebapci icin olmazsa olmaz olan iyi servis ve guleryuzlu ilgili personeli burda hayal bile etmeyin.	SERVICE#GENERAL SERVICE#GENERAL
Servis de personel de koca bir "0"	SERVICE#GENERAL SERVICE#GENERAL
servis yavastu .	SERVICE#GENERAL
garson a nie yavas oldugunu sordugumda 500 kisi var normaldir cvbini aldim.	SERVICE#GENERAL
marifet bes yuz kisi almakta degil bunlar :	
hizli sunabilmekte...	
kesinlikle tercih etmicem bi daha	RESTAURANT#GENERAL
normal - Pizzalari yeterince ince ama spesifik bir tadi eksik,mekan olarakta cok ozel olmadigindan gidilmesine gerek olmayan bir yer kanimca.	AMBIENCE#GENERAL FOOD#QUALITY
Rezalet otesi bir mekan.	RESTAURANT#GENERAL
Cok kaba saba garsonlari ve hizmeti olan dandik bir mekan.	SERVICE#GENERAL RESTAURANT#GENERAL
Manzarasi disinda tirt, sunumu da berbat gercekten.	SERVICE#GENERAL RESTAURANT#GENERAL AMBIENCE#GENERAL
Tatli yemek istedik kalkin baska yere oturun dedi terbiyesizler.	SERVICE#GENERAL
Tevazuya gerek yok abartÄ± da deÄŸil.	RESTAURANT#GENERAL
Ä°stanbulun en iyi dÃ¶nerini yapÄ±yorlar.	FOOD#QUALITY
Kaliteli lezzeti zaten biz deÄŸerlendiremeyiz.	
Ancak servis harika 250 kiÅŸilik dÃ¼kkanda herkese yetiÅŸiyorlar.	SERVICE#GENERAL
DÃ¶nerin yanÄ±ndaki patates, salata bile sÃ¼per.	FOOD#QUALITY
HavuÃ§ dilimi tatlÄ± da denenebilir.	FOOD#QUALITY
Tek eksik ayranÄ± kendilerinin yapmamasÄ±.	DRINKS#STYLE_OPTIONS
BÃ¶yle bir yer iÃ§in el yapÄ±mÄ± ayran ÅŸart.	DRINKS#STYLE_OPTIONS
Mekan Ã§ok gÃ¼zel, menÃ¼de 10larca seÃ§enek var ama malesef yemekler lezzetli deÄŸil.	FOOD#STYLE_OPTIONS AMBIENCE#GENERAL FOOD#QUALITY
TÃ¼m puanÄ± mekan hakediyor.	RESTAURANT#GENERAL AMBIENCE#GENERAL
Kahve iÃ§mek isterseniz gÃ¼zel bir tercih ama yemek yemek iÃ§in aynÄ± ÅŸeyi sÃ¶yleyemeyeceÄŸim	FOOD#QUALITY DRINKS#QUALITY
BÃ¼yÃ¼k porsiyonlar anca bir normal porsiyon olduÄŸunda kÃ¼Ã§Ã¼k pizzalari tavsiye edemem.	FOOD#STYLE_OPTIONS
Anca atÄ±ÅŸtÄ±rmalik olur.	
Ortam olarak baya kÃ¼Ã§Ã¼k bir dÃ¼kkÃ¢n ve ortakÃ¶ye uygun.	AMBIENCE#GENERAL
Hamur biraz fazla inceydi ve peynir daha bol olabilir.	FOOD#STYLE_OPTIONS FOOD#STYLE_OPTIONS
Domates sosu malesef Ã§ok zayif kaldi ve pizzanin seviyesini dÃ¼ÅŸÃ¼rÃ¼yor.	FOOD#STYLE_OPTIONS FOOD#QUALITY
Fiyatlar orta ile yÃ¼ksek arasi.	RESTAURANT#PRICES
Kendi biralarÄ±nÄ± Ã§oÄŸunluÄŸun aksine pek beÄŸenmedim, hatta ilk defa bir birayÄ± bitiremedim.	DRINKS#QUALITY
Biraz boÄŸucu bir mekan, haftasonlari Ã¶zellikle Ã§ok kalabalÄ±k oluyor.	AMBIENCE#GENERAL
KalabalÄ±ÄŸÄ±n iÃ§inde hiÃ§ beklenmeyecek kadar ferah ve gÃ¼zel bir mekan.	AMBIENCE#GENERAL
Bunun dÄ±ÅŸÄ±nda, her ne kadar Ã§oÄŸu zaman talebi karÅŸÄ±lamasa da sunduklarÄ± bira menÃ¼sÃ¼ burayÄ± Ã§ok Ã§ekici kÄ±lÄ±yor.	RESTAURANT#GENERAL DRINKS#STYLE_OPTIONS
Yemekleri de Ã§eÅŸit konusunda Ã§ok zengin deÄŸil ama lezzetli.	FOOD#STYLE_OPTIONS FOOD#QUALITY
Denediklerimizden, Tavuk Schnitzel mÃ¼kemmel, Tavuklu Wrap harikaydÄ±!	FOOD#QUALITY FOOD#QUALITY
Bir de Ã§eÅŸitli homemade ice tea ve limonatalarÄ± gerÃ§ekten baÅŸarÄ±lÄ± :	DRINKS#QUALITY
Etleri mezeleri basarili ama porsiyonlar inanilmaz buyuk.	FOOD#QUALITY FOOD#STYLE_OPTIONS
3 kisi 2 kisi icin getirdiklerini rahatlikla yiyebilir.	FOOD#STYLE_OPTIONS
3 gidip 2 kisilik getirin derseniz yiyecekler bu sekilde geliyor ama kisi basina 70tl yaziyorlar cok sacma olmus	FOOD#PRICES
5 Ã§ayÄ±nÄ±n ideal adresi karakÃ¶y'de dem.	RESTAURANT#GENERAL
50'den fazla Ã§ay Ã§eÅŸidi ile damak zevkinizi bi yerde yakalayacaÄŸÄ± kesin!	DRINKS#STYLE_OPTIONS
Benim tavsiyem vanilya aromalÄ± bourban vanilla, tatlÄ± ihtiyacÄ±nÄ±z iÃ§inse damla sakÄ±zlÄ± mastika keki.	DRINKS#QUALITY FOOD#QUALITY
Hizmet, ilgi alaka herÅŸey ÅŸahane!	SERVICE#GENERAL
iyi ki gittim de yedim dediÄŸim bir ÅŸey yok.	FOOD#QUALITY
hatta aynÄ± ÅŸeyleri yediÄŸim diÄŸer gÃ¼llÃ¼oÄŸlu ÅŸubeleri bence daha taze ve lezzetliydi.	
oturma yeri de Ã§ok yok.	AMBIENCE#GENERAL
bu kadar meÅŸhur olmasÄ± bana garip geldi aÃ§Ä±kÃ§asÄ±.	RESTAURANT#GENERAL
Manzara severlere...	AMBIENCE#GENERAL
- O manzaraya bu yemekler, bu servis olmamis :	AMBIENCE#GENERAL FOOD#QUALITY SERVICE#GENERAL
(( Ãœstelik fiyatlarda, yemeklerine nazaran uygun degil.	FOOD#PRICES FOOD#QUALITY
Yemekleri iÃ§in giderseniz memnuniyetsiz ayrilabilirsiniz; ama manzara seviyorsaniz kesin gidilmeli.	AMBIENCE#GENERAL FOOD#QUALITY
Hele de Istanbul hayraniysaniz, iste o zaman hiÃ§ tereddÃ¼t etmeyin...	
KadikÃ¶y'de gitmekten zevk aldÄ±ÄŸÄ±m mekanlardan birtanesi.	RESTAURANT#GENERAL
English pub tarzÄ±nda dekorasyona sahip, bira Ã§eÅŸitliliÄŸi fazla olan tarz bir mekan.	AMBIENCE#GENERAL AMBIENCE#GENERAL DRINKS#STYLE_OPTIONS
Yemek olarak schinitzel ve burger denedik, biranÄ±n yanÄ±nda iyi gitti.	FOOD#QUALITY
KÄ±ÅŸ aylarÄ±nda iÃ§eride oturmanÄ±zÄ± Ã¶neririm dekorasyon ve ortam keyif veriyor...	AMBIENCE#GENERAL
MaÃ§ gÃ¼nleri rez.	
yaptÄ±rsanÄ±z iyi olur.	
Dekorasyonu renkleri cok sicak ve sevimli.	AMBIENCE#GENERAL AMBIENCE#GENERAL
Ev yemeÄŸi yemek isteyenler iÃ§in ideal bur mekan tek bir ÅŸartla ne yiyecegini bilmen lazÄ±m Ã§Ã¼nkÃ¼ hersey cok lezzetli degil.	FOOD#QUALITY FOOD#QUALITY
Servis yavas, Ã§alÄ±ÅŸanlarÄ±n birbirleriyle diyaloglarÄ±ni da pek sevmedim.	SERVICE#GENERAL SERVICE#GENERAL
Mekan kalabalÄ±k olduÄŸunda stres kontrolu diye biÅŸey kalmiyor sanirim.	SERVICE#GENERAL
Ä°stanbul ÅŸubesi Ã§okta gÃ¼zel deÄŸil Ã§aldÄ±klarÄ± mÃ¼zikler hard rock'tan Ã§ok popÃ¼ler olmuÅŸ.	AMBIENCE#GENERAL RESTAURANT#GENERAL
AynÄ± konsept servisi gÃ¼zel ama diÄŸerleriyle kÄ±yaslandÄ±ÄŸÄ±nda biraz vadat ve taksim iÃ§in pahalÄ±	
Arka bahÃ§esi tÃ¼m yorgunluÄŸunu alÄ±yor insanÄ±n.	AMBIENCE#GENERAL
KoÅŸuyolunun en iyilerinden kirpi en Ã§ok diyet yapanlarÄ±n sevdiÄŸi bir mekan Ã§Ã¼nkÃ¼ menÃ¼sÃ¼ saÄŸlÄ±klÄ± beslenmeye uygun.	FOOD#STYLE_OPTIONS RESTAURANT#GENERAL
Masa yerlesimleri pek guzel degil oturma duzeni olmamis.	AMBIENCE#GENERAL AMBIENCE#GENERAL
Yer bulmak da zor oluyor.	SERVICE#GENERAL
Cok cesitli caylar var ancak fiyatlari biraz yuksek.	DRINKS#PRICES DRINKS#STYLE_OPTIONS
Ä°ngiliz cayi istedigimde sut getirmediler gerekce olarak da kotu oldugunh soylediler garson tersledi hatta	SERVICE#GENERAL
KurufasÃ¼lye ne kadar deÄŸiÅŸik olabilir demeyin Bizce Kuru'da yediÄŸim kurufasulyeden gelen hafif ÅŸekerli tat beni kendine hayran bÄ±raktÄ± resmen.	FOOD#QUALITY FOOD#QUALITY
TereyaÄŸlÄ± pilavlarÄ± ve tava yoÄŸurdu da Ã§ok baÅŸarÄ±lÄ±.	FOOD#QUALITY FOOD#QUALITY
Ãœzerine bal ve fÄ±ndÄ±k dÃ¶kÃ¼lmÃ¼ÅŸ sÃ¼tlaÃ§larÄ± Ã§ok cezbedici gÃ¶zÃ¼kse de sÃ¼tlaÃ§ tadÄ±nÄ± alamadÄ±m daha Ã§ok muhallebi gibiydi.	FOOD#QUALITY FOOD#STYLE_OPTIONS
AyrÄ±ca hergun Ã§Ä±kardÄ±klarÄ± farklÄ± zeytinyaÄŸlÄ± yemekleri de Ã§ok baÅŸarÄ±lÄ±.	FOOD#QUALITY
Fiyatlar ortalamanÄ±n biraz ustunde malesef.	RESTAURANT#PRICES
Ogle yumegi zaman roll sushi menu var.	
33TL acaba icecek icinde.	
Biraz once gittim .	
Ama fiyat degisti olabilir.	
Serviste cok guzel.	SERVICE#GENERAL
Ortam cok guzel.	AMBIENCE#GENERAL
Lezzetliydi.	FOOD#QUALITY
En beÄŸendigimiz sushico ÅŸubesi.	RESTAURANT#GENERAL
BahÃ§esi Ã§ok gÃ¼zel ve ferah.	AMBIENCE#GENERAL
Sushi ustasi cok becerikli ve ÅŸakaci :	SERVICE#GENERAL
) yogun oldugu saatlerde servis biraz aksak olsa da kabul edilebilir buluyoruz	SERVICE#GENERAL
MenÃ¼ Ã§eÅŸitleri zengin.	FOOD#STYLE_OPTIONS
FiyatlarÄ± normalin biraz Ã¼stÃ¼nde ama yinede caddedeki yorgunluÄŸu atmanÄ±z iÃ§in ferah ferah oturabileceÄŸiniz mekan.	AMBIENCE#GENERAL RESTAURANT#PRICES
Muhallebici ama...	
- Herkesin muhallebisini ya da sÃ¼t tatlilari yedigi yerin ben kÃ¼nefesini begeniyorum.	FOOD#QUALITY
GeÃ§en sene haftada bir kÃ¼nefe yemege giderdim.	
Favorilerim biÃ§ak arasi ve saÃ§ arasi ama tavuk sis ve diger ekmeklerde (kasarli ve kiymali) Ã§ok basarili.	FOOD#QUALITY FOOD#QUALITY FOOD#QUALITY FOOD#QUALITY
Konyada yemedim ama yiyenlerinde begendigi bir mekan.	RESTAURANT#GENERAL
Servis iyi olmadigindan michelin yildizli yemek yapsalar gÃ¶zÃ¼me gÃ¶rÃ¼nmÃ¼yor.	SERVICE#GENERAL
35 derece yaz sicaginda buzdolaplari bozuk diye sicak kola getirdiler bu sefer de.	DRINKS#QUALITY
Buradan iÃ§eri girersiniz karÅŸÄ±lamasÄ±ndan tutunda etten Ã¶nce gelen kuverdeki turÅŸuya kadar hepsi Ã¶zenle seÃ§ilmiÅŸ hazÄ±rlanmÄ±ÅŸ mekanÄ±n ve tatlarÄ±n iÃ§inde gezer durursunuz.	FOOD#QUALITY RESTAURANT#GENERAL
Et menÃ¼sÃ¼nden istediÄŸinizi seÃ§ebilirsiniz hepsi olabileceÄŸinin en iyisidir .	FOOD#QUALITY
TatlÄ±lar da bir o kadar harikadÄ±r.	FOOD#QUALITY
MekanÄ±n sahibi Beyti Bey her oraya gidiÅŸinizde masanÄ±za uÄŸrayÄ±p selam verir.	SERVICE#GENERAL
SÃ¶ylenecek daha da birÅŸey yok kesinlikle gÃ¼zel yemek yemek istiyor ve risk almak istemiyorsanÄ±z bana kalÄ±rsa Beyti'den iyisi yoktur !	FOOD#QUALITY
Ã–zellikle yabancÄ± misafirlerinizi aÄŸÄ±rlamak iÃ§in osmanlÄ± tarzÄ± dekorasyonu ve akÄ±l almaz lezzetleri sayesinde tÃ¼rk mutfaÄŸÄ±nÄ± tanÄ±tmak iÃ§in Ã§ok uygun...	FOOD#QUALITY AMBIENCE#GENERAL
Servis kotu, mekan fazla aydinlik ve gurultulu.	AMBIENCE#GENERAL SERVICE#GENERAL
Garsonlarin ilgisizligi cabasi.	SERVICE#GENERAL
Yemekler soguk ve gec geliyor.	FOOD#QUALITY SERVICE#GENERAL
Tek guzelligi Marina manzarasi.	AMBIENCE#GENERAL
Bide Cikolatali Karayip katlarini met etmeden yapamiycam.	FOOD#QUALITY
Ä°stikrarli.	RESTAURANT#GENERAL
- Her gittigimde bir Ã¶ncekinden daha kÃ¶tÃ¼ susi yapmayi nasil yapmayi beceriyorlar?	FOOD#QUALITY
So so - Ã‡ok bir sey beklemeyin, Quick China kadar iyi degil.	
Bu akimin Ã¶ncÃ¼lerinden; ancak Quick China bence Sushico'yu solladi.	
Sushiler gene basarili; ama yemekler ciddi anlamda bozuldu.	FOOD#QUALITY FOOD#QUALITY
Sanirim ahÃ§i isten ayrildi.	
Cok guzel hepsi birbirinden guzel yemeklerinizz ve lezzetli sonrasinda.	FOOD#QUALITY
Garsonlarin servis sunumunda hersey dÃ¶rt dÃ¶rt lÃ¼k.	SERVICE#GENERAL
Tesekkur ediyorum.	RESTAURANT#GENERAL
Calisanlara ve sizlere.	
Cem Boyraz	
Tavsiye bicak arasi yemeniz .	FOOD#QUALITY
Masanin bir ucundan diger ucuna kadar uzaniyir konya mutfagindan farkli lezzetler deneyin fiyatlar uygun geldi .	FOOD#STYLE_OPTIONS
Ã‡ikolatalÄ± Saray muhallebisi , krem karamel ve ayva tatlÄ±sÄ±ndan tabaklarca yiyebilirim.	FOOD#QUALITY FOOD#QUALITY FOOD#QUALITY
Bu konuda onlarÄ±n eline kolay kolay kimse su sÃ¼remez.	RESTAURANT#GENERAL
Ã‡ok aÃ§sanÄ±z pilav Ã¼stÃ¼ dÃ¶neri deneminizi tavsiye ederim.	FOOD#QUALITY
Sadece teras katÄ± oturulabilir olan bi ÅŸubesi.	AMBIENCE#GENERAL
DiÄŸer katlara pekte gerek yokmuÅŸ.	RESTAURANT#GENERAL
Ã‡alÄ±ÅŸanlar oldukca ilgili alakalÄ± .	SERVICE#GENERAL
fiyatlar aynÄ± yani normal .	RESTAURANT#PRICES
teras katÄ±nda tatlÄ±nÄ±zÄ± yiyip Ã§ayÄ±nÄ±zÄ± yudumlayabilirsiniz.	AMBIENCE#GENERAL
Denemek lazim - Ã–gle arasinda is yerinden arkadaslar ile gittik.	RESTAURANT#GENERAL
BiÃ§ak arasi iyi, saÃ§ arasi mÃ¼kemmel, garsonlar ilgisiz ve fiyatlar uÃ§mus.	FOOD#PRICES FOOD#QUALITY FOOD#QUALITY SERVICE#GENERAL
Ama gene de gitmek lazim.	RESTAURANT#GENERAL
Etli ekmeÄŸinin Konya'daki mekanlardan bile daha lezzetli olduÄŸunu dÃ¼ÅŸÃ¼ndÃ¼ÄŸÃ¼m mekan/dÄ±.	FOOD#QUALITY
BaÅŸakÅŸehir ÅŸubesi aÃ§Ä±ldÄ±ÄŸÄ±ndan beri o eski OvalÄ± deÄŸil.	RESTAURANT#GENERAL
BaÅŸakÅŸehir'deki aÃ§Ä±k ara daha iyi.	
mekanÄ±n yeri Ã§ok gÃ¼zel.	LOCATION#GENERAL
Ã§alÄ±ÅŸanlarÄ± kibar.	SERVICE#GENERAL
lezzetine gÃ¼venebileceÄŸiniz bir zincir zaten.	FOOD#QUALITY
deniz Ã¼rÃ¼nleri salatasÄ± Ã§ok lezzetli.	FOOD#QUALITY
ahtapot, karides, kalamar, somon fÃ¼me ; ne ararsanÄ±z var iÃ§inde.	FOOD#STYLE_OPTIONS
saÄŸlÄ±klÄ± ve hafif.	FOOD#QUALITY
ToplantÄ± iÃ§in KalkÄ±p Florya Lara kadar gidip beklentiye baÄŸlÄ± olarak hayal kÄ±rÄ±klÄ±ÄŸÄ± yaratan mekan.	RESTAURANT#GENERAL
DÄ±ÅŸarÄ±dan lÃ¼ks gibi gÃ¶rÃ¼nse de artÄ±k tarihi geÃ§miÅŸ mekan gÃ¶rÃ¼ntÃ¼sÃ¼ vermekte ve iÃ§erideki aksesuarlar gÃ¶z yormakta.	AMBIENCE#GENERAL AMBIENCE#GENERAL
Yemeklere gelince dÃ¶ner tatsÄ±z tuzsuz, et kÃ¶fte PÄ±nar'Ä±n et kÃ¶ftesinden daha kÃ¶tÃ¼, kÄ±rmÄ±zÄ± et hafifÃ§e sert ve keyifsizdi.	FOOD#QUALITY FOOD#QUALITY FOOD#QUALITY
Belki kÃ¼nefe iyidir diye dÃ¼ÅŸÃ¼nÃ¼rken kÃ¼nefenin peynirden yoksun olmasÄ± hayal kÄ±rÄ±klÄ±ÄŸÄ±mÄ±zÄ± Ã¼st seviyeye Ã§Ä±kardÄ±.	FOOD#QUALITY
Illa kebap yemek istiyorsanÄ±z baÅŸka tercihlere yÃ¶nelin derim...	FOOD#QUALITY
Uzun zamandir gitmemistim ve iyi ki gitmemisim.	RESTAURANT#GENERAL
Gercekten lahmacunu tavugu berbatti ve gelen hesap 2 kisi 169tl.	FOOD#QUALITY FOOD#PRICES
Hic tavsiye etmiyorum , design deseniz zaten ic karartici ve demode	AMBIENCE#GENERAL
100 lira fix menuye gittik 8 kisi 1600 tl odedik 1 buyuk raki ictik toplamda.	RESTAURANT#PRICES
kahve ve caylar 200 tl tutmus heryerde cay ikramdir hemde 1600 tl hesap verene uzak durun	DRINKS#PRICES
EÄŸer deniz kenarÄ±nda yer bulabilirseniz oturumu Ã§ok keyifli.	AMBIENCE#GENERAL
Mekan Ã§ok bÃ¼yÃ¼k olduÄŸu iÃ§in personel yetiÅŸemiyo ve servis sÃ¼rekli aksÄ±yor.	SERVICE#GENERAL SERVICE#GENERAL
Yemekleri gayet gÃ¼zel	FOOD#QUALITY
Ä°ftar servisini Ã§ok zayÄ±f bulduk.	SERVICE#GENERAL
500 kiÅŸiye kaliteli servis verilemiyorsa 300 kiÅŸiye daha iyi ÅŸartlar saÄŸlanabilir diye dÃ¼ÅŸÃ¼nÃ¼yorum.	SERVICE#GENERAL
Ramazanda tavsiye etmiyorum.	RESTAURANT#GENERAL
Bana sushiyi sevdiren tek yer diyebilirim Ã§alÄ±ÅŸanlarÄ± o kadar gÃ¼ler yÃ¼zlÃ¼ ki.	SERVICE#GENERAL
Bu fiyata bÃ¶yle bir memnuniyet Ã§ok az rastlanacak ÅŸey .	RESTAURANT#PRICES
Mekan hiÃ§ boÄŸucu degil gayet gÃ¼zel	AMBIENCE#GENERAL
Akrabalar bizi goturdu.	
Burasi turkiyedeki eti restoran olarak mukenmel restorant biriymis.	
Tabi ki et yemekler hepsi cok harika.	FOOD#QUALITY
Tarihi bina da begendim.	AMBIENCE#GENERAL
TereyaÄŸlÄ± Mercimek Ã‡orbasÄ± ve BÄ±Ã§ak arasÄ± muhteÅŸem ikili diyebilirim.	FOOD#QUALITY FOOD#QUALITY
Her Åubesi'nde aynÄ± kaliteyi yakalamÄ±ÅŸlar.	RESTAURANT#GENERAL
Sadece dÃ¶ner olayÄ±nÄ± pek yapamÄ±yorlar.	FOOD#QUALITY
Servis saatlerinde bolca kalabalik olan ilgili bir mekan ambiyans olarak farkli bir lezzet tadacaginizi size bildiriyor.	AMBIENCE#GENERAL
Farkli tatlar icin dusunulebilinir.	FOOD#STYLE_OPTIONS
Tavuklarin iri dogranmis olmasi pek hos degil.	FOOD#STYLE_OPTIONS
Pilavda su tadi aliyorsunuz.	FOOD#QUALITY
Bir de Ã¼stÃ¼ne 9,5 TL veriyorsunuz.	RESTAURANT#PRICES
Afiyet oldu mu simdi bana :	
Tercih etmem - Pazar gÃ¼nÃ¼ kahvalti iÃ§in gittim.	FOOD#QUALITY
Daha Ã¶nce Nisantasi'nda ki subeye gitmistim ve inanilmaz gÃ¼zel kahvalti etmistim ve memnun kalmistim.	FOOD#QUALITY
Ama bu sefer Beyoglu'nda ki subede hiÃ§ memnun kalmadim.	RESTAURANT#GENERAL
Manzarasi yat limani Garsonlari ilgi alakali ozellikle Ege bey.	SERVICE#GENERAL
Ancak fiyatlar ile yemek karsilastirmasi bence uyumsuz yuksek standartlar icermekte Ayni mekanda daha Ã§ok Ã§eÅŸit var Ä°sim satÄ±yor birazz Dikkat !	FOOD#PRICES
Konumu, manzarasÄ±, lezzeti ÅŸahane...	FOOD#QUALITY AMBIENCE#GENERAL LOCATION#GENERAL
Bir arkadaÅŸÄ±mÄ±n Ä±srarÄ± ile lahmacun yemiÅŸtim ki benim yediÄŸim en gÃ¼zel lahmacundu...	FOOD#QUALITY
KebaplarÄ± zaten muazzam :	FOOD#QUALITY
Yani en basitinden en zoruna...	
Hepsi harika...	RESTAURANT#GENERAL
AyrÄ±ca sigara iÃ§meyenlerin dostu olmasÄ± dolayÄ±sÄ±yla bu mekan benim en favorilerimden :	RESTAURANT#MISCELLANEOUS
Bu mekan newyorkta olsa yemek yemek iÃ§in bir sene Ã¶nceden rezervasyon yaptÄ±rmak gerekirdi.	
PÄ±rÄ±l pÄ±rÄ±l salonlar GÃ¼ler yÃ¼zlÃ¼ ve temiz garsonlar.	AMBIENCE#GENERAL SERVICE#GENERAL
Etler iÃ§in yoruma gerek yok.	FOOD#QUALITY
Ã–zellikle favorim bakÄ±r kapta gelen kuzu kol , bunu bu ÅŸekilde baÅŸka yerde yemeniz olanaksÄ±z.	FOOD#QUALITY
zeytinyaÄŸlÄ±lar sÃ¼per Ã¶zellikle imambayÄ±ldÄ± titretiyor insanÄ±,alkol iÃ§meyecekseniz mukakkak koyu ayranÄ± iÃ§menizi tavsiye ederim.	DRINKS#QUALITY FOOD#QUALITY FOOD#QUALITY
Ä°ÅŸ fiyatlara gelince Ã¶yle bir mekan iÃ§in normal fakat beyti kalitesinde Avrupa veya Amerika'da yer iseniz 3 kat fazlasÄ±nÄ± Ã¶demek zorundasÄ±nÄ±z.	RESTAURANT#PRICES
Mahalle lokantasi - Yillardan beri Sushico Nisantasi'nda.	
Ara sira gidilebilecek bir lokanta.	RESTAURANT#GENERAL
Susileri belli bir seviyede her zaman, asagi dÃ¼smÃ¼yor.	FOOD#QUALITY
Ã‡in yemekleri de fena degil.	FOOD#QUALITY
sabahlarÄ± bÃ¶rekleri.	
Ã¶ÄŸle ve akÅŸam yemekleriyle her ÅŸubesinde aynÄ± kaliteyi yakalamÄ±ÅŸ mekan.	FOOD#QUALITY
tatlÄ±larÄ±nÄ± Ã¶vmeye gerek bile gÃ¶rmÃ¼yorum.	FOOD#QUALITY
yazÄ±n dondurmasÄ± da denenmeli.	FOOD#QUALITY
SÃ¼tlÃ¼ tatlilari mÃ¼kemmel diyebilirim.	FOOD#QUALITY
Ã‡ayi gÃ¼zel.	DRINKS#QUALITY
DÃ¶neri Ã§ogu insan tarafindan sevilmese de ben seviyorum.	FOOD#QUALITY
Ama iskenderi gÃ¼zel degil.	FOOD#QUALITY
Sos isini beceremiyorlar.	FOOD#QUALITY
Yanindaki yogurt gÃ¼zel ama.	FOOD#QUALITY
Bazen gereksiz derecede Ã§ok kalabalik olabiliyor.	AMBIENCE#GENERAL
Kebap ve Et restoranlarÄ± aleminde sÄ±kÃ§a karÅŸÄ±laÅŸÄ±lan lezzet ve ambiyans paradoksunu Ã§Ã¶zmÃ¼ÅŸ bir mekan.	AMBIENCE#GENERAL FOOD#QUALITY
Lahmacun ve iÃ§likÃ¶fte iyi fakat dolmalarÄ± Antep usulÃ¼nde Ä°stanbul'da yediklerim arasÄ±nda en iyilerdendi.	FOOD#QUALITY FOOD#QUALITY
Etler malzeme, marinasyon, piÅŸirme ve sunum aÃ§Ä±sÄ±ndan Ã§ok baÅŸarÄ±lÄ±.	FOOD#QUALITY FOOD#STYLE_OPTIONS
Ã–zellikle fÄ±stÄ±klÄ± kebap favorim.	FOOD#QUALITY
Katmer de muazzam.	FOOD#QUALITY
Ambiyans ve dekorasyon titizlikle tasarlanmÄ±ÅŸ olan bu mekanda menÃ¼ye baÄŸlÄ± kalmayatak tamamen sizin isteklerinize gÃ¶re sipariÅŸ verebiliyorsunuz.	AMBIENCE#GENERAL FOOD#STYLE_OPTIONS
Manzara sÃ¼per,yemekler fena deÄŸil ama porsiyon miktarÄ± Ã§ook Ã§ook azz o fiyatÄ± kesinlikle haketmiyor.	AMBIENCE#GENERAL FOOD#QUALITY FOOD#STYLE_OPTIONS
happymoons daha iyi daha uygun we porsiyonlarÄ± Ã§ok bÃ¼yÃ¼k.	
Ã§ok sÄ±cak Ã§ok kalabalÄ±k denizden koku geliyor yemekleri orta garsonlar ilgisiz kahvaltÄ±sÄ± zayÄ±f Ã¼zerine gidip Saray dan subÃ¶reÄŸi yedik otopark Ã¼cretsiz diyip Ã¼cret alÄ±yor	AMBIENCE#GENERAL SERVICE#GENERAL FOOD#QUALITY FOOD#QUALITY
Ã‡alÄ±ÅŸanlar kesinlikle Ã§ok nezih.	SERVICE#GENERAL
Ã‡ayÄ± da gÃ¼zel yapÄ±yorlar yanÄ±na da su bÃ¶reÄŸi .	DRINKS#QUALITY FOOD#QUALITY
Tavsiye ederim.	RESTAURANT#GENERAL
Istiklal Caddesi'ne girdiÄŸinizde solda kalÄ±yor.	LOCATION#GENERAL
Deniz kenarÄ±nda olan bÃ¼tÃ¼n mekanlarÄ±n aurasÄ± baÅŸka tabi adÄ± birde FenerbahÃ§e olursa...	AMBIENCE#GENERAL
AÃ§Ä±ldÄ±ÄŸÄ±ndan bu yana buranÄ±n keyfini Ã§Ä±karmayÄ± Ã§ok seviyorum.	RESTAURANT#GENERAL
Klasik lezzetler...	FOOD#QUALITY
